name,male.freq,female.freq,male.count,female.count,total.count
A,0.705882352941177,0.294117647058824,24,10,34
A.,1,0,15,0,15
Aabel,1,0,51,0,51
Aabraham,1,0,78,0,78
Aabram,1,0,16,0,16
Aada,0,1,0,7833,7833
Aada-Emilia,0,1,0,19,19
Aadaliina,0,1,0,12,12
Aadalmiina,0,1,0,11,11
Aadam,1,0,79,0,79
Aada-Maria,0,1,0,54,54
Aada-Sofia,0,1,0,37,37
Aadel,1,0,10,0,10
Aadi,1,0,16,0,16
Aadiel,1,0,21,0,21
Aadolf,1,0,463,0,463
Aadolfiina,0,1,0,18,18
Aage,1,0,23,0,23
Aagot,0,1,0,12,12
Aake,1,0,395,0,395
Aaku,1,0,40,0,40
Aala,0,1,0,17,17
Aale,0.9375,0.0625,150,10,160
Aalia,0,1,0,26,26
Aaliyah,0,1,0,15,15
Aallotar,0,1,0,436,436
Aalo,0,1,0,11,11
Aalto,1,0,64,0,64
Aamina,0,1,0,17,17
Aamos,1,0,630,0,630
Aamu,0,1,0,838,838
Aamutähti,0,1,0,11,11
Aana,0,1,0,59,59
Äänis,1,0,32,0,32
Aapa,1,0,10,0,10
Aape,1,0,20,0,20
Aapel,1,0,11,0,11
Aapeli,1,0,2134,0,2134
Aapi,1,0,48,0,48
Aapo,1,0,5750,0,5750
Aapo-Matti,1,0,11,0,11
Aappi,1,0,11,0,11
Aappo,1,0,381,0,381
Aapraham,1,0,35,0,35
Aapram,1,0,32,0,32
Aaprami,1,0,149,0,149
Aapro,1,0,34,0,34
Aare,1,0,54,0,54
Aaret,1,0,34,0,34
Aaretti,1,0,192,0,192
Aari,1,0,58,0,58
Aaria,0,1,0,34,34
Aarika,0,1,0,14,14
Aarla,0,1,0,14,14
Aarne,1,0,9320,0,9320
Aarnenpoika,1,0,16,0,16
Aarni,1,0,2205,0,2205
Aarno,1,0,3038,0,3038
Aaro,1,0,7467,0,7467
Aaron,1,0,5444,0,5444
Aaroni,1,0,33,0,33
Aaronpoika,1,0,17,0,17
Aarre,1,0,5313,0,5313
Aarto,1,0,364,0,364
Aasa,0,1,0,26,26
Aatami,1,0,516,0,516
Aate,1,0,318,0,318
Aati,1,0,200,0,200
Aato,1,0,17,0,17
Aatos,1,0,7080,0,7080
Aatto,1,0,942,0,942
Aatu,1,0,4646,0,4646
Aava,0,1,0,2161,2161
Aba,0,1,0,11,11
Abas,1,0,12,0,12
Abbas,0.801242236024845,0.198757763975155,129,32,161
Abbe,1,0,19,0,19
Abd,0.758620689655172,0.241379310344828,44,14,58
Abdalla,1,0,26,0,26
Abdallah,1,0,55,0,55
Abdel,1,0,70,0,70
Abdelaziz,1,0,25,0,25
Abdelghani,1,0,10,0,10
Abdelhamid,1,0,12,0,12
Abdelkader,1,0,18,0,18
Abdelkarim,1,0,18,0,18
Abdellah,1,0,22,0,22
Abdellatif,1,0,14,0,14
Abdelmajid,1,0,13,0,13
Abdelrahman,1,0,15,0,15
Abderrahim,1,0,15,0,15
Abderrahman,1,0,10,0,10
Abderrahmane,1,0,21,0,21
Abdi,0.597977243994943,0.402022756005057,473,318,791
Abdiasis,0.644444444444444,0.355555555555556,29,16,45
Abdiaziz,0.745762711864407,0.254237288135593,44,15,59
Abdifatah,0.816091954022989,0.183908045977011,71,16,87
Abdihakim,1,0,22,0,22
Abdihakin,1,0,10,0,10
Abdihamid,1,0,12,0,12
Abdikadir,0.578947368421053,0.421052631578947,22,16,38
Abdikarim,0.733333333333333,0.266666666666667,33,12,45
Abdikarin,0.533333333333333,0.466666666666667,24,21,45
Abdillahi,0.538461538461538,0.461538461538462,21,18,39
Abdimalik,1,0,19,0,19
Abdinasir,0.769230769230769,0.230769230769231,40,12,52
Abdinur,1,0,10,0,10
Abdiqani,1,0,25,0,25
Abdirahim,1,0,29,0,29
Abdirahmaan,1,0,16,0,16
Abdirahman,0.773694390715667,0.226305609284333,400,117,517
Abdirashid,0.566666666666667,0.433333333333333,68,52,120
Abdirazak,1,0,14,0,14
Abdirisak,0.746268656716418,0.253731343283582,50,17,67
Abdirisaq,0.583333333333333,0.416666666666667,21,15,36
Abdirizak,0.627272727272727,0.372727272727273,69,41,110
Abdisalam,0.652173913043478,0.347826086956522,30,16,46
Abdisamad,1,0,10,0,10
Abdishakur,1,0,18,0,18
Abdiwahab,1,0,11,0,11
Abdiwali,1,0,16,0,16
Abdiweli,0.615384615384615,0.384615384615385,16,10,26
Abdou,1,0,11,0,11
Abdoulie,1,0,13,0,13
Abdukadir,1,0,16,0,16
Abdul,0.859459459459459,0.140540540540541,159,26,185
Abdulaahi,1,0,10,0,10
Abdulahi,1,0,49,0,49
Abdulaziz,1,0,13,0,13
Abdulgadir,1,0,15,0,15
Abdulhamid,1,0,10,0,10
Abdulkadir,0.64026402640264,0.35973597359736,194,109,303
Abdulkarim,1,0,18,0,18
Abdulla,1,0,39,0,39
Abdullaahi,1,0,17,0,17
Abdullah,0.875675675675676,0.124324324324324,162,23,185
Abdullahi,0.651908396946565,0.348091603053435,427,228,655
Abdulle,0.475,0.525,19,21,40
Abdulqadir,1,0,17,0,17
Abdulrahman,1,0,36,0,36
Abdurahman,1,0,23,0,23
Abdurrahman,1,0,22,0,22
Abed,0.645833333333333,0.354166666666667,31,17,48
Abel,1,0,199,0,199
Abena,0,1,0,12,12
Abid,1,0,13,0,13
Abiel,1,0,87,0,87
Abigail,0,1,0,121,121
Abiodun,1,0,10,0,10
Abner,1,0,35,0,35
Abraham,1,0,354,0,354
Abram,1,0,94,0,94
Abshir,0.65,0.35,26,14,40
Abu,1,0,23,0,23
Abubakar,1,0,23,0,23
Abukar,0.60952380952381,0.39047619047619,64,41,105
Achieng,0,1,0,11,11
Achilles,1,0,13,0,13
Ada,0,1,0,3714,3714
Ada-Emilia,0,1,0,26,26
Adalbert,1,0,17,0,17
Adalia,0,1,0,102,102
Adaliina,0,1,0,48,48
Adalina,0,1,0,15,15
Adalmiina,0,1,0,1573,1573
Adalmina,0,1,0,260,260
Adam,0.982481751824818,0.0175182481751825,1346,24,1370
Adama,0,1,0,12,12
Ada-Maria,0,1,0,46,46
Adan,0.555555555555556,0.444444444444444,50,40,90
Adanna,0,1,0,52,52
Ada-Sofia,0,1,0,52,52
Adea,0,1,0,25,25
Adel,0.767123287671233,0.232876712328767,56,17,73
Adela,0,1,0,130,130
Adelaide,0,1,0,60,60
Adele,0,1,0,3213,3213
Adéle,0,1,0,355,355
Adèle,0,1,0,58,58
Adelé,0,1,0,33,33
Adelea,0,1,0,25,25
Adelei,0,1,0,17,17
Adelein,0,1,0,27,27
Adeleine,0,1,0,30,30
Adelheid,0,1,0,19,19
Adelia,0,1,0,364,364
Adelie,0,1,0,27,27
Adeliina,0,1,0,869,869
Adelin,0,1,0,17,17
Adelina,0,1,0,522,522
Adeline,0,1,0,103,103
Adella,0,1,0,62,62
Adelle,0,1,0,33,33
Adelma,0,1,0,12,12
Adelmiina,0,1,0,11,11
Adem,1,0,31,0,31
Aden,0.688888888888889,0.311111111111111,93,42,135
Adessa,0,1,0,174,174
Adette,0,1,0,17,17
Adi,0.777777777777778,0.222222222222222,35,10,45
Adiel,1,0,260,0,260
Adil,0.818181818181818,0.181818181818182,63,14,77
Adile,0,1,0,25,25
Adina,0,1,0,284,284
Adine,0,1,0,28,28
Adjoa,0,1,0,10,10
Adna,0,1,0,38,38
Adnaan,1,0,10,0,10
Adnan,0.877049180327869,0.122950819672131,107,15,122
Adolf,1,0,1159,0,1159
Adolfiina,0,1,0,227,227
Adolfina,0,1,0,76,76
Adolfo,1,0,15,0,15
Adonika,0,1,0,23,23
Adonis,1,0,12,0,12
Adora,0,1,0,17,17
Adrian,1,0,894,0,894
Adrián,1,0,11,0,11
Adriana,0,1,0,201,201
Adrianna,0,1,0,16,16
Adriano,1,0,20,0,20
Adrien,1,0,18,0,18
Adrienne,0,1,0,25,25
Afnaan,0,1,0,11,11
Afrim,1,0,21,0,21
Agafia,0,1,0,30,30
Agape,0,1,0,10,10
Agata,0,1,0,66,66
Agatha,0,1,0,72,72
Agathon,1,0,16,0,16
Agda,0,1,0,138,138
Age,1,0,16,0,16
Agim,1,0,21,0,21
Agne,0,1,0,11,11
Agneeta,0,1,0,15,15
Agneetta,0,1,0,15,15
Agnes,0,1,0,768,768
Ágnes,0,1,0,13,13
Agnesa,0,1,0,22,22
Agneta,0,1,0,1348,1348
Agnete,0,1,0,42,42
Agnetha,0,1,0,34,34
Agnetta,0,1,0,10,10
Agnia,0,1,0,23,23
Agnieszka,0,1,0,25,25
Agon,1,0,10,0,10
Agostino,1,0,12,0,12
Agron,1,0,12,0,12
Agustin,1,0,12,0,12
Ahlam,0,1,0,11,11
Ahmad,0.941747572815534,0.058252427184466,291,18,309
Ahmed,0.725195429945881,0.274804570054119,1206,457,1663
Ahmet,1,0,75,0,75
Ahti,1,0,5748,0,5748
Ahto,1,0,168,0,168
Ahvo,1,0,45,0,45
Ai,0,1,0,29,29
Aia,0,1,0,10,10
Aicha,0,1,0,82,82
Aida,0,1,0,911,911
Aidan,1,0,64,0,64
Aiden,1,0,31,0,31
Aidi,0,1,0,11,11
Aihe,1,0,13,0,13
Aija,0,1,0,2245,2245
Aija-Leena,0,1,0,37,37
Aija-Liisa,0,1,0,26,26
Aija-Riitta,0,1,0,15,15
Aiju,0,1,0,30,30
Aiko,0,1,0,21,21
Aila,0,1,0,12695,12695
Ailakki,0,1,0,48,48
Aile,0,1,0,27,27
Áile,0,1,0,11,11
Aileen,0,1,0,21,21
Aili,0,1,0,7378,7378
Ailiina,0,1,0,42,42
Ailikki,0,1,0,43,43
Ailin,0,1,0,16,16
Ailo,1,0,60,0,60
Ailu,1,0,29,0,29
Aiman,1,0,27,0,27
Aime,0,1,0,17,17
Aimee,0,1,0,21,21
Aimée,0,1,0,17,17
Aimi,0,1,0,48,48
Aimo,1,0,6870,0,6870
Aimonpoika,1,0,10,0,10
Aina,0,1,0,759,759
Aina-Maria,0,1,0,15,15
Ainamo,0,1,0,92,92
Aini,0,1,0,2818,2818
Ainikki,0,1,0,387,387
Aino,0,1,0,35905,35905
Aino-Elina,0,1,0,67,67
Aino-Elisa,0,1,0,11,11
Aino-Emilia,0,1,0,35,35
Aino-Helena,0,1,0,12,12
Aino-Ilona,0,1,0,23,23
Aino-Inkeri,0,1,0,44,44
Aino-Kaarina,0,1,0,11,11
Ainokaisa,0,1,0,25,25
Aino-Kaisa,0,1,0,152,152
Aino-Leena,0,1,0,29,29
Ainoliina,0,1,0,20,20
Aino-Liina,0,1,0,11,11
Ainoliisa,0,1,0,21,21
Aino-Liisa,0,1,0,74,74
Aino-Lotta,0,1,0,10,10
Aino-Maaria,0,1,0,17,17
Ainomaija,0,1,0,52,52
Aino-Maija,0,1,0,260,260
Ainomari,0,1,0,17,17
Aino-Mari,0,1,0,30,30
Ainomaria,0,1,0,48,48
Aino-Maria,0,1,0,295,295
Aino-Marja,0,1,0,31,31
Aino-Marjatta,0,1,0,10,10
Aino-Riitta,0,1,0,14,14
Aino-Sisko,0,1,0,13,13
Aino-Sofia,0,1,0,73,73
Ainu,0,1,0,105,105
Aira,0,1,0,4804,4804
Aira-Liisa,0,1,0,13,13
Aire,0,1,0,48,48
Airi,0,1,0,7369,7369
Airiina,0,1,0,35,35
Airikki,0,1,0,24,24
Aisha,0,1,0,271,271
Aisla,0,1,0,55,55
Aissa,0,1,0,15,15
Aito,1,0,117,0,117
Aivar,1,0,16,0,16
Aivi,0,1,0,59,59
Ajla,0,1,0,17,17
Akam,1,0,12,0,12
Akatius,1,0,10,0,10
Akbar,1,0,20,0,20
Ake,1,0,44,0,44
Åke,1,0,1800,0,1800
Åkesdotter,0,1,0,14,14
Åkesson,1,0,17,0,17
Aki,1,0,8902,0,8902
Akif,1,0,16,0,16
Aki-Jussi,1,0,14,0,14
Akil,1,0,12,0,12
Akiliina,0,1,0,12,12
Akilles,1,0,130,0,130
Akim,1,0,19,0,19
Aki-Matti,1,0,42,0,42
Akinpoika,1,0,48,0,48
Akintytär,0,1,0,24,24
Aki-Pekka,1,0,56,0,56
Aki-Petri,1,0,15,0,15
Aki-Petteri,1,0,104,0,104
Akira,1,0,27,0,27
Akke,1,0,18,0,18
Ako,1,0,23,0,23
Akram,0.827586206896552,0.172413793103448,48,10,58
Aksa,0,1,0,24,24
Aksana,0,1,0,10,10
Aksel,1,0,846,0,846
Akseli,1,0,10618,0,10618
Akseliina,0,1,0,14,14
Akselinpoika,1,0,10,0,10
Aksiina,0,1,0,33,33
Aksu,1,0,130,0,130
Aku,1,0,3116,0,3116
Akua,0,1,0,12,12
Akuliina,0,1,0,101,101
Aku-Matti,1,0,23,0,23
Akunpoika,1,0,10,0,10
Aku-Pekka,1,0,40,0,40
Aku-Petteri,1,0,45,0,45
Akusti,1,0,406,0,406
Aku-Ville,1,0,15,0,15
Akveliina,0,1,0,15,15
Akviliina,0,1,0,22,22
Al,1,0,26,0,26
Ala,0,1,0,12,12
Alaa,0.576923076923077,0.423076923076923,15,11,26
Alain,1,0,55,0,55
Alan,1,0,238,0,238
Alana,0,1,0,31,31
Alanna,0,1,0,17,17
Alari,1,0,39,0,39
Alaric,1,0,14,0,14
Alarik,1,0,2121,0,2121
Alawi,1,0,10,0,10
Alba,0,1,0,46,46
Alban,1,0,31,0,31
Albana,0,1,0,15,15
Albanus,1,0,15,0,15
Albert,1,0,4813,0,4813
Alberta,0,1,0,20,20
Albertiina,0,1,0,143,143
Albertina,0,1,0,107,107
Alberto,1,0,177,0,177
Albertti,1,0,49,0,49
Albiinus,1,0,11,0,11
Albin,1,0,1470,0,1470
Albina,0,1,0,51,51
Albinus,1,0,80,0,80
Albion,1,0,20,0,20
Albulena,0,1,0,16,16
Alda,0,1,0,30,30
Aldi,0,1,0,11,11
Aldin,1,0,20,0,20
Aldo,1,0,24,0,24
Aldur,1,0,13,0,13
Ale,1,0,112,0,112
Alea,0,1,0,18,18
Alec,1,0,253,0,253
Alecia,0,1,0,13,13
Alef,1,0,15,0,15
Aleftina,0,1,0,12,12
Aleida,0,1,0,13,13
Alejandra,0,1,0,45,45
Alejandro,1,0,132,0,132
Alek,1,0,64,0,64
Aleks,1,0,233,0,233
Aleksa,0,1,0,34,34
Aleksanda,0,1,0,10,10
Aleksandar,1,0,28,0,28
Aleksander,1,0,2797,0,2797
Aleksandr,1,0,395,0,395
Aleksandra,0,1,0,12481,12481
Aleksandria,0,1,0,21,21
Aleksandros,1,0,19,0,19
Aleksandrovna,0,1,0,70,70
Aleksanter,1,0,13,0,13
Aleksanteri,1,0,12068,0,12068
Aleksantra,0,1,0,69,69
Alekseevna,0,1,0,15,15
Aleksei,1,0,529,0,529
Aleksej,1,0,31,0,31
Aleksejevna,0,1,0,12,12
Aleksey,1,0,10,0,10
Aleksi,1,0,38958,0,38958
Aleksia,0,1,0,93,93
Aleksiina,0,1,0,425,425
Aleksina,0,1,0,64,64
Aleksinpoika,1,0,21,0,21
Aleksis,1,0,1610,0,1610
Aleksius,1,0,65,0,65
Alen,1,0,20,0,20
Alena,0,1,0,102,102
Ales,1,0,25,0,25
Alesia,0,1,0,19,19
Alessa,0,1,0,76,76
Alessandra,0,1,0,189,189
Alessandro,1,0,156,0,156
Alessia,0,1,0,200,200
Alessio,1,0,41,0,41
Aletta,0,1,0,133,133
Alette,0,1,0,17,17
Alevtina,0,1,0,27,27
Alex,0.996624305003971,0.00337569499602859,5019,17,5036
Alexa,0,1,0,147,147
Alexander,1,0,12195,0,12195
Alexandr,1,0,79,0,79
Alexandra,0,1,0,11639,11639
Alexandre,1,0,300,0,300
Alexandria,0,1,0,77,77
Alexandrine,0,1,0,16,16
Alexandro,1,0,26,0,26
Alexandros,1,0,101,0,101
Alexandrovna,0,1,0,10,10
Alexandru,1,0,28,0,28
Alexanteri,1,0,48,0,48
Alexei,1,0,173,0,173
Alexej,1,0,43,0,43
Alexey,1,0,122,0,122
Alexi,1,0,279,0,279
Alexia,0,1,0,260,260
Alexiina,0,1,0,35,35
Alexina,0,1,0,71,71
Alexis,0.893491124260355,0.106508875739645,302,36,338
Alexius,1,0,29,0,29
Alexsander,1,0,69,0,69
Alexsandra,0,1,0,363,363
Alexsanteri,1,0,14,0,14
Aleyna,0,1,0,21,21
Alf,1,0,1254,0,1254
Alfa,0,1,0,42,42
Alf-Erik,1,0,24,0,24
Alfhild,0,1,0,138,138
Alfhilda,0,1,0,31,31
Alfiina,0,1,0,26,26
Alfina,0,1,0,11,11
Alfons,1,0,752,0,752
Alfonso,1,0,39,0,39
Alfred,1,0,2697,0,2697
Alfredo,1,0,37,0,37
Alfrida,0,1,0,45,45
Algot,1,0,210,0,210
Alho,1,0,43,0,43
Ali,0.865653738504598,0.134346261495402,2165,336,2501
Alia,0,1,0,52,52
Alica,0,1,0,56,56
Alice,0,1,0,5183,5183
Alicia,0,1,0,580,580
Alicja,0,1,0,18,18
Alida,0,1,0,124,124
Alieu,1,0,12,0,12
Aliida,0,1,0,27,27
Aliina,0,1,0,2268,2268
Aliisa,0,1,0,5390,5390
Aliise,0,1,0,68,68
Aliisi,0,1,0,78,78
Alina,0,1,0,9014,9014
Alinda,0,1,0,132,132
Aline,0,1,0,112,112
Alireza,1,0,19,0,19
Alisa,0,1,0,6795,6795
Alise,0,1,0,489,489
Alisha,0,1,0,30,30
Alisi,0,1,0,13,13
Alisia,0,1,0,80,80
Alison,0,1,0,45,45
Alissa,0,1,0,548,548
Alistair,1,0,14,0,14
Alita,0,1,0,10,10
Alix,0,1,0,18,18
Aliya,0,1,0,11,11
Aliyah,0,1,0,20,20
Aliza,0,1,0,12,12
Alja,0,1,0,13,13
Alje,1,0,12,0,12
Aljona,0,1,0,14,14
Alku,1,0,10,0,10
Alla,0,1,0,189,189
Allan,1,0,10839,0,10839
Allani,1,0,68,0,68
Allari,1,0,19,0,19
Allegra,0,1,0,20,20
Allen,1,0,49,0,49
Alli,0,1,0,3518,3518
Allida,0,1,0,18,18
Alliina,0,1,0,10,10
Allison,0,1,0,21,21
Allu,1,0,35,0,35
Alma,0,1,0,3288,3288
Almar,1,0,10,0,10
Almaz,0,1,0,11,11
Almer,1,0,18,0,18
Almida,0,1,0,12,12
Almiina,0,1,0,26,26
Almina,0,1,0,12,12
Almir,1,0,16,0,16
Almira,0,1,0,15,15
Alois,1,0,17,0,17
Alon,1,0,11,0,11
Alona,0,1,0,18,18
Alonso,1,0,17,0,17
Alonzo,1,0,15,0,15
Alper,1,0,23,0,23
Alpert,1,0,17,0,17
Alpertti,1,0,164,0,164
Alpha,1,0,10,0,10
Alpi,1,0,175,0,175
Alpiin,1,0,32,0,32
Alpin,1,0,13,0,13
Alpo,1,0,5198,0,5198
Alrik,1,0,16,0,16
Althea,0,1,0,18,18
Altti,1,0,1082,0,1082
Alva,0,1,0,695,695
Alvar,1,0,3624,0,3624
Alvari,1,0,1137,0,1137
Alvaro,1,0,32,0,32
Alve,1,0,29,0,29
Alvi,0.933070866141732,0.0669291338582677,237,17,254
Alvian,1,0,15,0,15
Alviina,0,1,0,244,244
Alviira,0,1,0,10,10
Alvin,1,0,306,0,306
Alvina,0,1,0,125,125
Alwan,0.565217391304348,0.434782608695652,13,10,23
Alwar,1,0,21,0,21
Alwin,1,0,22,0,22
Aly,1,0,14,0,14
Alyssa,0,1,0,109,109
Ama,0,1,0,33,33
Amaal,0,1,0,21,21
Amadea,0,1,0,26,26
Amadeo,1,0,11,0,11
Amadeus,1,0,255,0,255
Amadou,1,0,17,0,17
Amaia,0,1,0,15,15
Amal,0,1,0,93,93
Amalia,0,1,0,3906,3906
Amalie,0,1,0,48,48
Amaliina,0,1,0,13,13
Aman,1,0,15,0,15
Amanda,0,1,0,19584,19584
Amandine,0,1,0,18,18
Amandus,1,0,19,0,19
Amani,0.263157894736842,0.736842105263158,10,28,38
Amar,1,0,55,0,55
Amara,0,1,0,12,12
Amaru,1,0,13,0,13
Amatus,1,0,10,0,10
Amaya,0,1,0,22,22
Amber,0,1,0,33,33
Ambrosia,0,1,0,15,15
Ambrosius,1,0,18,0,18
Amel,0,1,0,16,16
Amela,0,1,0,12,12
Amelia,0,1,0,1266,1266
Amélia,0,1,0,12,12
Amelie,0,1,0,936,936
Amélie,0,1,0,130,130
Amelié,0,1,0,21,21
Ameliina,0,1,0,25,25
Amer,1,0,24,0,24
Ami,0.819148936170213,0.180851063829787,231,51,282
Amie,0,1,0,27,27
Amiel,1,0,13,0,13
Amiin,1,0,19,0,19
Amiira,0,1,0,30,30
Amila,0,1,0,13,13
Amilda,0,1,0,26,26
Amilia,0,1,0,50,50
Amin,1,0,239,0,239
Amina,0,1,0,363,363
Aminah,0,1,0,10,10
Aminata,0,1,0,21,21
Aminda,0,1,0,16,16
Amine,0.583333333333333,0.416666666666667,28,20,48
Amino,0,1,0,11,11
Amir,1,0,320,0,320
Amira,0,1,0,255,255
Amit,1,0,20,0,20
Amjad,1,0,22,0,22
Ammar,1,0,37,0,37
Ammi,0,1,0,13,13
Amna,0,1,0,16,16
Amon,1,0,22,0,22
Amor,1,0,22,0,22
Amorina,0,1,0,10,10
Amos,1,0,562,0,562
Amr,1,0,14,0,14
Amra,0,1,0,16,16
Amran,0,1,0,13,13
Amrita,0,1,0,23,23
Amy,0,1,0,188,188
An,0.564516129032258,0.435483870967742,35,27,62
Ana,0,1,0,168,168
Anab,0,1,0,30,30
Anabel,0,1,0,26,26
Anabella,0,1,0,11,11
Anahita,0,1,0,23,23
Anais,0,1,0,23,23
Anaïs,0,1,0,34,34
Anakin,1,0,16,0,16
Anand,1,0,11,0,11
Ananda,0.5,0.5,13,13,26
Ananias,1,0,108,0,108
Anas,1,0,121,0,121
Anastaasia,0,1,0,26,26
Anastacia,0,1,0,209,209
Anastasia,0,1,0,1896,1896
Anastasija,0,1,0,57,57
Anastasios,1,0,13,0,13
Anastasiya,0,1,0,13,13
Anastassia,0,1,0,58,58
Anatole,1,0,10,0,10
Anatoli,1,0,138,0,138
Anatolij,1,0,14,0,14
Anatoljevna,0,1,0,28,28
Anatoly,1,0,15,0,15
Ancela,0,1,0,58,58
Ancelica,0,1,0,10,10
Anceliga,0,1,0,127,127
Ancelika,0,1,0,49,49
Ancelina,0,1,0,13,13
Andaras,1,0,10,0,10
Andeliina,0,1,0,11,11
Anders,1,0,6697,0,6697
Andersdotter,0,1,0,38,38
Andersson,1,0,15,0,15
Andi,1,0,24,0,24
András,1,0,34,0,34
Andre,1,0,230,0,230
André,1,0,969,0,969
Andrè,1,0,19,0,19
Andrea,0.16793893129771,0.83206106870229,132,654,786
Andréa,0,1,0,68,68
Andreas,1,0,5200,0,5200
Andréas,1,0,76,0,76
Andree,1,0,11,0,11
Andreea,0,1,0,12,12
Andrei,1,0,750,0,750
Andrej,1,0,77,0,77
Andres,1,0,146,0,146
Andrés,1,0,60,0,60
Andrew,1,0,414,0,414
Andrey,1,0,153,0,153
Andriy,1,0,15,0,15
Andrus,1,0,12,0,12
Andrzej,1,0,18,0,18
Andy,1,0,75,0,75
Ane,0,1,0,10,10
Anela,0,1,0,12,12
Anele,0,1,0,12,12
Anelma,0,1,0,2979,2979
Anemone,0,1,0,10,10
Anerva,0,1,0,16,16
Anervo,0,1,0,13,13
Anesa,0,1,0,12,12
Anessa,0,1,0,11,11
Anet,0,1,0,13,13
Aneta,0,1,0,13,13
Anett,0,1,0,48,48
Anetta,0,1,0,75,75
Anette,0,1,0,3640,3640
Anfisa,0,1,0,15,15
Angel,0.445255474452555,0.554744525547445,61,76,137
Angela,0,1,0,483,483
Angeles,0,1,0,10,10
Angeli,0,1,0,26,26
Angelica,0,1,0,750,750
Angeliina,0,1,0,61,61
Angelika,0,1,0,412,412
Angeliki,0,1,0,10,10
Angelina,0,1,0,538,538
Angeline,0,1,0,19,19
Angelique,0,1,0,77,77
Angelita,0,1,0,15,15
Angelo,1,0,119,0,119
Angelos,1,0,27,0,27
Angervo,0,1,0,75,75
Angie,0,1,0,13,13
Angus,1,0,28,0,28
Anh,0.446428571428571,0.553571428571429,100,124,224
Ani,0,1,0,197,197
Ania,0,1,0,43,43
Anian,1,0,51,0,51
Aniara,0,1,0,14,14
Anica,0,1,0,11,11
Anida,0,1,0,13,13
Aniela,0,1,0,42,42
Anielka,0,1,0,11,11
Aniina,0,1,0,27,27
Aniita,0,1,0,149,149
Aniitta,0,1,0,352,352
Anika,0,1,0,97,97
Anikka,0,1,0,10,10
Anil,1,0,12,0,12
Anila,0,1,0,15,15
Anilla,0,1,0,33,33
Anima,0,1,0,12,12
Anina,0,1,0,88,88
Anine,0,1,0,13,13
Aninka,0,1,0,27,27
Anis,1,0,20,0,20
Anisa,0,1,0,108,108
Anisia,0,1,0,12,12
Anissa,0,1,0,43,43
Anita,0,1,0,23020,23020
Anitra,0,1,0,239,239
Anitta,0,1,0,4936,4936
Anja,0,1,0,26189,26189
Anja-Kaarina,0,1,0,25,25
Anja-Leena,0,1,0,46,46
Anja-Liisa,0,1,0,107,107
Anja-Maija,0,1,0,25,25
Anja-Maria,0,1,0,21,21
Anja-Riitta,0,1,0,131,131
Anjatta,0,1,0,14,14
Anjelica,0,1,0,10,10
Anjelika,0,1,0,18,18
Anju,0,1,0,23,23
Anjuli,0,1,0,12,12
Anjuska,0,1,0,43,43
Anki,0,1,0,70,70
Anmari,0,1,0,75,75
Ann,0,1,0,1100,1100
Anna,0,1,0,46928,46928
Annabel,0,1,0,175,175
Annabell,0,1,0,28,28
Annabella,0,1,0,306,306
Anna-Bella,0,1,0,35,35
Annabelle,0,1,0,39,39
Anna-Brita,0,1,0,31,31
Anna-Carin,0,1,0,13,13
Anna-Christina,0,1,0,11,11
Anna-Eliisa,0,1,0,11,11
Anna-Elina,0,1,0,150,150
Anna-Elisa,0,1,0,26,26
Anna-Emilia,0,1,0,134,134
Anna-Erika,0,1,0,25,25
Anna-Eveliina,0,1,0,16,16
Anna-Greetta,0,1,0,11,11
Anna-Greta,0,1,0,97,97
Anna-Helena,0,1,0,79,79
Anna-Ilona,0,1,0,15,15
Anna-Inkeri,0,1,0,15,15
Anna-Johanna,0,1,0,10,10
Anna-Julia,0,1,0,35,35
Anna-Juulia,0,1,0,13,13
Anna-Kaarina,0,1,0,307,307
Anna-Kaija,0,1,0,59,59
Annakaisa,0,1,0,260,260
Anna-Kaisa,0,1,0,1701,1701
Anna-Kajsa,0,1,0,21,21
Anna-Karin,0,1,0,111,111
Anna-Karoliina,0,1,0,82,82
Anna-Katariina,0,1,0,105,105
Anna-Katarina,0,1,0,26,26
Anna-Katri,0,1,0,49,49
Anna-Katriina,0,1,0,62,62
Anna-Kerttu,0,1,0,10,10
Anna-Kreeta,0,1,0,19,19
Anna-Kreetta,0,1,0,23,23
Anna-Kristiina,0,1,0,143,143
Anna-Kristina,0,1,0,33,33
Anna-Laura,0,1,0,16,16
Annalea,0,1,0,14,14
Anna-Lea,0,1,0,27,27
Anna-Leea,0,1,0,28,28
Annaleena,0,1,0,199,199
Anna-Leena,0,1,0,1270,1270
Annalena,0,1,0,15,15
Anna-Lena,0,1,0,316,316
Annaliina,0,1,0,64,64
Anna-Liina,0,1,0,27,27
Annaliisa,0,1,0,330,330
Anna-Liisa,0,1,0,10894,10894
Anna-Linnea,0,1,0,12,12
Annalisa,0,1,0,31,31
Anna-Lisa,0,1,0,443,443
Annalotta,0,1,0,15,15
Anna-Lotta,0,1,0,77,77
Anna-Loviisa,0,1,0,10,10
Anna-Lovisa,0,1,0,10,10
Anna-Lyydia,0,1,0,14,14
Anna-Maaret,0,1,0,11,11
Annamaaria,0,1,0,26,26
Anna-Maaria,0,1,0,119,119
Anna-Maarit,0,1,0,65,65
Annamaija,0,1,0,243,243
Anna-Maija,0,1,0,3351,3351
Anna-Maj,0,1,0,20,20
Annamari,0,1,0,969,969
Anna-Mari,0,1,0,1392,1392
Annamaria,0,1,0,286,286
Anna-Maria,0,1,0,2296,2296
Anna-Marie,0,1,0,36,36
Anna-Mariia,0,1,0,12,12
Anna-Marika,0,1,0,18,18
Anna-Marja,0,1,0,142,142
Anna-Marjatta,0,1,0,12,12
Anna-Matilda,0,1,0,15,15
Annami,0,1,0,50,50
Anna-Mi,0,1,0,20,20
Anna-Mia,0,1,0,11,11
Anna-Miia,0,1,0,11,11
Anna-Pauliina,0,1,0,35,35
Anna-Pia,0,1,0,15,15
Anna-Reeta,0,1,0,53,53
Annareetta,0,1,0,26,26
Anna-Reetta,0,1,0,146,146
Annariikka,0,1,0,61,61
Anna-Riikka,0,1,0,285,285
Annariina,0,1,0,130,130
Anna-Riina,0,1,0,69,69
Annariitta,0,1,0,29,29
Anna-Riitta,0,1,0,291,291
Anna-Roosa,0,1,0,10,10
Annarosa,0,1,0,11,11
Anna-Rosa,0,1,0,10,10
Anna-Sara,0,1,0,11,11
Anna-Sisko,0,1,0,21,21
Annasofia,0,1,0,32,32
Anna-Sofia,0,1,0,573,573
Annastiina,0,1,0,811,811
Anna-Stiina,0,1,0,116,116
Annastina,0,1,0,120,120
Anna-Stina,0,1,0,158,158
Anna-Tuulia,0,1,0,29,29
Anna-Ulla,0,1,0,10,10
Ann-Britt,0,1,0,242,242
Ann-Caroline,0,1,0,21,21
Ann-Cathrin,0,1,0,20,20
Ann-Cathrine,0,1,0,30,30
Ann-Catrin,0,1,0,78,78
Ann-Catrine,0,1,0,31,31
Ann-Charlott,0,1,0,102,102
Ann-Charlotta,0,1,0,11,11
Ann-Charlotte,0,1,0,320,320
Ann-Chatrine,0,1,0,10,10
Ann-Christin,0,1,0,430,430
Ann-Christina,0,1,0,14,14
Ann-Christine,0,1,0,500,500
Ann-Cristin,0,1,0,12,12
Ann-Cristine,0,1,0,15,15
Anne,0,1,0,35241,35241
Annea,0,1,0,17,17
Anne-Birgitta,0,1,0,11,11
Anne-Britt,0,1,0,17,17
Anne-Charlotte,0,1,0,48,48
Anne-Christine,0,1,0,43,43
Anne-Elina,0,1,0,22,22
Anne-Helena,0,1,0,31,31
Anneka,0,1,0,98,98
Anne-Kaarina,0,1,0,42,42
Anne-Kaisa,0,1,0,14,14
Anne-Katariina,0,1,0,14,14
Anneke,0,1,0,18,18
Anne-Kristiina,0,1,0,90,90
Anne-Kristina,0,1,0,17,17
Annel,0,1,0,37,37
Annele,0,1,0,2213,2213
Anne-Leena,0,1,0,31,31
Anneli,0,1,0,125723,125723
Annelie,0,1,0,134,134
Anne-Lie,0,1,0,10,10
Anneliese,0,1,0,10,10
Anneliina,0,1,0,62,62
Anne-Liisa,0,1,0,53,53
Annelise,0,1,0,20,20
Anne-Louise,0,1,0,10,10
Annely,0,1,0,12,12
Anne-Maaret,0,1,0,35,35
Anne-Maaria,0,1,0,34,34
Anne-Maarit,0,1,0,592,592
Anne-Mai,0,1,0,31,31
Anne-Maija,0,1,0,223,223
Annemaj,0,1,0,12,12
Anne-Maj,0,1,0,661,661
Annemari,0,1,0,531,531
Anne-Mari,0,1,0,2616,2616
Annemaria,0,1,0,34,34
Anne-Maria,0,1,0,1235,1235
Annemarie,0,1,0,68,68
Anne-Marie,0,1,0,1143,1143
Anne-Marika,0,1,0,37,37
Anne-Marit,0,1,0,12,12
Anne-Marita,0,1,0,87,87
Anne-Maritta,0,1,0,30,30
Anne-Marja,0,1,0,195,195
Anne-Marjatta,0,1,0,15,15
Anne-Marjo,0,1,0,20,20
Anne-Marjut,0,1,0,45,45
Anne-May,0,1,0,80,80
Annemi,0,1,0,32,32
Annemo,0,1,0,16,16
Annentytär,0,1,0,11,11
Anne-Riikka,0,1,0,10,10
Anne-Riitta,0,1,0,105,105
Anne-Sisko,0,1,0,15,15
Anne-Sofie,0,1,0,12,12
Anne-Sophie,0,1,0,10,10
Annett,0,1,0,15,15
Annetta,0,1,0,17,17
Annette,0,1,0,1480,1480
Annevi,0,1,0,21,21
Ann-Gret,0,1,0,19,19
Ann-Helen,0,1,0,82,82
Ann-Helene,0,1,0,11,11
Anni,0,1,0,19558,19558
Annica,0,1,0,433,433
Annie,0,1,0,365,365
Anni-Elina,0,1,0,59,59
Anni-Emilia,0,1,0,42,42
Anni-Eveliina,0,1,0,10,10
Anni-Helena,0,1,0,30,30
Anni-Ilona,0,1,0,20,20
Anniina,0,1,0,15015,15015
Anni-Julia,0,1,0,13,13
Annika,0,1,0,23215,23215
Annikaisa,0,1,0,16,16
Anni-Kaisa,0,1,0,73,73
Annikka,0,1,0,799,799
Annikki,0,1,0,62459,62459
Annileena,0,1,0,19,19
Anni-Leena,0,1,0,39,39
Anniliina,0,1,0,44,44
Anni-Liina,0,1,0,11,11
Anni-Liisa,0,1,0,15,15
Annilotta,0,1,0,16,16
Anni-Lotta,0,1,0,25,25
Anni-Maaria,0,1,0,19,19
Anni-Maarit,0,1,0,10,10
Annimaija,0,1,0,19,19
Anni-Maija,0,1,0,58,58
Anni-Maj,0,1,0,23,23
Annimari,0,1,0,68,68
Anni-Mari,0,1,0,95,95
Annimaria,0,1,0,42,42
Anni-Maria,0,1,0,204,204
Anni-Marja,0,1,0,17,17
Annina,0,1,0,2797,2797
Anni-Pauliina,0,1,0,10,10
Anni-Riikka,0,1,0,16,16
Anni-Riina,0,1,0,11,11
Anni-Riitta,0,1,0,11,11
Anni-Roosa,0,1,0,10,10
Anni-Sofia,0,1,0,99,99
Annita,0,1,0,14,14
Ann-Jeanette,0,1,0,14,14
Ann-Katrin,0,1,0,123,123
Ann-Katrine,0,1,0,26,26
Ann-Kristin,0,1,0,271,271
Ann-Kristine,0,1,0,20,20
Ann-Len,0,1,0,14,14
Annlis,0,1,0,14,14
Ann-Lis,0,1,0,160,160
Ann-Louis,0,1,0,12,12
Ann-Louise,0,1,0,238,238
Ann-Maarit,0,1,0,16,16
Ann-Maj,0,1,0,185,185
Annmari,0,1,0,99,99
Ann-Mari,0,1,0,1310,1310
Ann-Maria,0,1,0,51,51
Annmarie,0,1,0,35,35
Ann-Marie,0,1,0,672,672
Ann-May,0,1,0,32,32
Ann-Nina,0,1,0,33,33
Annsofi,0,1,0,10,10
Ann-Sofi,0,1,0,385,385
Ann-Sofia,0,1,0,22,22
Ann-Sofie,0,1,0,333,333
Ann-Sophie,0,1,0,25,25
Annu,0,1,0,878,878
Annuka,0,1,0,16,16
Annukka,0,1,0,6393,6393
Annuli,0,1,0,87,87
Annuliina,0,1,0,16,16
Annu-Maria,0,1,0,13,13
Annuska,0,1,0,16,16
Ann-Viol,0,1,0,13,13
Anny,0,1,0,19,19
Ano,1,0,156,0,156
Anouar,1,0,10,0,10
Anouk,0,1,0,10,10
Anri,0,1,0,333,333
Anriikka,0,1,0,22,22
Anrika,0,1,0,13,13
Ansa,0,1,0,939,939
Anse,1,0,13,0,13
Ansela,0,1,0,14,14
Anseli,1,0,12,0,12
Anseliina,0,1,0,13,13
Anselika,0,1,0,20,20
Anselm,1,0,710,0,710
Anselmi,1,0,2760,0,2760
Anselmiina,0,1,0,15,15
Anselmo,1,0,29,0,29
Ansgarius,1,0,18,0,18
Anshelm,1,0,111,0,111
Anshelmi,1,0,11,0,11
Ansio,1,0,19,0,19
Ansku,0,1,0,13,13
Anssi,1,0,6946,0,6946
Anssinpoika,1,0,33,0,33
Anssintytär,0,1,0,12,12
Anssi-Pekka,1,0,29,0,29
Anssi-Petteri,1,0,10,0,10
Ansu,1,0,29,0,29
Antamo,1,0,18,0,18
Ante,1,0,106,0,106
Ánte,1,0,10,0,10
Anteri,1,0,40,0,40
Antero,1,0,142641,0,142641
Anteronpoika,1,0,32,0,32
Anterus,1,0,25,0,25
Anthea,0,1,0,13,13
Anthon,1,0,93,0,93
Anthoni,1,0,12,0,12
Anthonio,1,0,23,0,23
Anthony,1,0,688,0,688
Antigona,0,1,0,11,11
Antinpoika,1,0,634,0,634
Antintytär,0,1,0,144,144
Antje,0,1,0,15,15
Anto,1,0,131,0,131
Antoine,1,0,68,0,68
Antoinette,0,1,0,135,135
Anton,1,0,12060,0,12060
Antonella,0,1,0,30,30
Antoni,1,0,157,0,157
Antonia,0,1,0,609,609
Antonie,0,1,0,10,10
Antonietta,0,1,0,10,10
Antoniina,0,1,0,26,26
Antonin,1,0,10,0,10
Antonina,0,1,0,221,221
Antonino,1,0,14,0,14
Antonio,1,0,821,0,821
António,1,0,10,0,10
Antonios,1,0,29,0,29
Antonis,1,0,19,0,19
Antonius,1,0,69,0,69
Antony,1,0,87,0,87
Antrea,1,0,13,0,13
Antreas,1,0,81,0,81
Antrei,1,0,24,0,24
Ants,1,0,10,0,10
Antte,1,0,60,0,60
Antti,1,0,56902,0,56902
Antti-Eemeli,1,0,26,0,26
Antti-Einari,1,0,13,0,13
Antti-Heikki,1,0,22,0,22
Antti-Ilari,1,0,12,0,12
Antti-Jaakko,1,0,18,0,18
Antti-Juhani,1,0,107,0,107
Antti-Jukka,1,0,16,0,16
Anttijussi,1,0,21,0,21
Antti-Jussi,1,0,482,0,482
Antti-Matias,1,0,13,0,13
Antti-Matti,1,0,40,0,40
Antti-Mikael,1,0,19,0,19
Antti-Mikko,1,0,14,0,14
Antti-Olavi,1,0,14,0,14
Antti-Olli,1,0,10,0,10
Antti-Oskari,1,0,38,0,38
Anttipekka,1,0,16,0,16
Antti-Pekka,1,0,444,0,444
Antti-Petteri,1,0,30,0,30
Antti-Sakari,1,0,10,0,10
Antti-Tapio,1,0,14,0,14
Antti-Veikko,1,0,30,0,30
Antti-Ville,1,0,77,0,77
Antto,1,0,517,0,517
Antton,1,0,1844,0,1844
Anttoni,1,0,1836,0,1836
Anttoniina,0,1,0,13,13
Anttonio,1,0,30,0,30
Anttony,1,0,11,0,11
Anttoo,1,0,14,0,14
Anttu,1,0,156,0,156
Anttuuna,0,1,0,13,13
Anu,0,1,0,13533,13533
Anu-Elina,0,1,0,19,19
Anu-Johanna,0,1,0,11,11
Anu-Kaisa,0,1,0,27,27
Anu-Kristiina,0,1,0,18,18
Anu-Leena,0,1,0,34,34
Anuliina,0,1,0,64,64
Anu-Liina,0,1,0,14,14
Anuliisa,0,1,0,23,23
Anu-Liisa,0,1,0,40,40
Anu-Maaria,0,1,0,15,15
Anu-Maarit,0,1,0,58,58
Anu-Maija,0,1,0,25,25
Anumari,0,1,0,11,11
Anu-Mari,0,1,0,35,35
Anu-Maria,0,1,0,54,54
Anu-Marika,0,1,0,11,11
Anu-Marja,0,1,0,12,12
Anu-Pauliina,0,1,0,12,12
Anuriikka,0,1,0,13,13
Anu-Riikka,0,1,0,70,70
Anu-Susanna,0,1,0,16,16
Anu-Tuulia,0,1,0,10,10
Anvi,0,1,0,12,12
Anwar,0.848837209302326,0.151162790697674,73,13,86
Anya,0,1,0,58,58
Anzelika,0,1,0,12,12
Anzhelika,0,1,0,18,18
Apila,0,1,0,21,21
Apollo,1,0,38,0,38
Apollon,1,0,11,0,11
Apollonia,0,1,0,38,38
April,0,1,0,47,47
Ara,1,0,34,0,34
Arabella,0,1,0,24,24
Aralia,0,1,0,15,15
Aram,1,0,70,0,70
Aramis,1,0,20,0,20
Aran,1,0,21,0,21
Aras,1,0,14,0,14
Arash,1,0,35,0,35
Araz,1,0,15,0,15
Arben,1,0,17,0,17
Arber,1,0,12,0,12
Arbnor,1,0,13,0,13
Arda,1,0,46,0,46
Ardian,1,0,19,0,19
Ardita,0,1,0,14,14
Are,1,0,32,0,32
Aren,1,0,11,0,11
Ares,1,0,15,0,15
Aret,1,0,12,0,12
Aretta,0,1,0,30,30
Arhi,1,0,26,0,26
Arhippa,1,0,72,0,72
Arho,1,0,82,0,82
Ari,1,0,30457,0,30457
Aria,0,1,0,28,28
Ariadna,0,1,0,12,12
Ariadne,0,1,0,23,23
Arian,1,0,68,0,68
Ariana,0,1,0,131,131
Ariane,0,1,0,28,28
Arianna,0,1,0,95,95
Arianne,0,1,0,33,33
Arie,1,0,13,0,13
Ariel,0.579831932773109,0.420168067226891,207,150,357
Ariela,0,1,0,70,70
Ariella,0,1,0,33,33
Arielle,0,1,0,17,17
Arietta,0,1,0,10,10
Arif,1,0,55,0,55
Ari-Heikki,1,0,24,0,24
Arijoutsi,1,0,70,0,70
Ari-Juha,1,0,12,0,12
Ari-Juhani,1,0,37,0,37
Ari-Jukka,1,0,101,0,101
Ari-Jussi,1,0,24,0,24
Arild,1,0,12,0,12
Arimatti,1,0,10,0,10
Ari-Matti,1,0,293,0,293
Ari-Mikko,1,0,19,0,19
Arimo,1,0,719,0,719
Arin,1,0,16,0,16
Arina,0,1,0,89,89
Arinpoika,1,0,207,0,207
Arintytär,0,1,0,57,57
Ario,1,0,16,0,16
Arion,1,0,14,0,14
Aripekka,1,0,32,0,32
Ari-Pekka,1,0,1750,0,1750
Ari-Petri,1,0,23,0,23
Ari-Petteri,1,0,47,0,47
Aris,1,0,16,0,16
Arisa,0,1,0,11,11
Aristoteles,1,0,11,0,11
Arita,0,1,0,85,85
Ari-Tapani,1,0,11,0,11
Ari-Tapio,1,0,10,0,10
Ari-Veikko,1,0,17,0,17
Ari-Ville,1,0,17,0,17
Arja,0,1,0,20589,20589
Arja-Helena,0,1,0,10,10
Arja-Leena,0,1,0,280,280
Arja-Liisa,0,1,0,323,323
Arja-Maija,0,1,0,20,20
Arja-Riitta,0,1,0,106,106
Arja-Sisko,0,1,0,18,18
Arja-Terttu,0,1,0,11,11
Arje,1,0,10,0,10
Arjo,1,0,46,0,46
Arkadi,1,0,18,0,18
Arkan,1,0,18,0,18
Arkko,1,0,13,0,13
Arla,0,1,0,288,288
Arleena,0,1,0,19,19
Arlena,0,1,0,14,14
Arlene,0,1,0,82,82
Arlette,0,1,0,17,17
Arlind,1,0,12,0,12
Arlinda,0,1,0,18,18
Arline,0,1,0,11,11
Arlo,1,0,14,0,14
Arma,0,1,0,33,33
Arman,1,0,99,0,99
Armand,1,0,26,0,26
Armando,1,0,67,0,67
Armas,1,0,17240,0,17240
Armend,1,0,16,0,16
Armi,0.00568884491714074,0.994311155082859,23,4020,4043
Armida,0,1,0,254,254
Armiida,0,1,0,333,333
Armin,1,0,55,0,55
Armo,1,0,135,0,135
Arn,1,0,25,0,25
Arna,0,1,0,56,56
Arndt,1,0,17,0,17
Arne,1,0,1147,0,1147
Arnevi,0,1,0,47,47
Arni,1,0,43,0,43
Arno,1,0,604,0,604
Arnold,1,0,525,0,525
Aro,1,0,33,0,33
Aron,1,0,687,0,687
Áron,1,0,15,0,15
Aronia,0,1,0,24,24
Arpia,1,0,13,0,13
Arpo,1,0,10,0,10
Arri,1,0,12,0,12
Arsen,1,0,11,0,11
Arseni,1,0,30,0,30
Arsi,1,0,501,0,501
Arssi,1,0,16,0,16
Art,1,0,13,0,13
Arta,0,1,0,19,19
Artan,1,0,17,0,17
Arte,1,0,15,0,15
Artem,1,0,114,0,114
Artemi,1,0,39,0,39
Artemis,0,1,0,20,20
Arthur,1,0,1160,0,1160
Artin,1,0,25,0,25
Artjom,1,0,46,0,46
Arto,1,0,19368,0,19368
Arton,1,0,15,0,15
Artonpoika,1,0,88,0,88
Artontytär,0,1,0,29,29
Arto-Pekka,1,0,16,0,16
Artti,1,0,70,0,70
Artto,1,0,27,0,27
Arttu,1,0,10676,0,10676
Arttu-Eemeli,1,0,12,0,12
Arttu-Oskari,1,0,11,0,11
Arttu-Pekka,1,0,38,0,38
Arttur,1,0,263,0,263
Artturi,1,0,8682,0,8682
Artunpoika,1,0,21,0,21
Artur,1,0,885,0,885
Arturo,1,0,39,0,39
Arun,1,0,23,0,23
Arvi,1,0,3788,0,3788
Arvid,1,0,2875,0,2875
Arviid,1,0,16,0,16
Arviiti,1,0,22,0,22
Arvin,1,0,26,0,26
Arvo,1,0,7675,0,7675
Arwen,0,1,0,30,30
Arwid,1,0,17,0,17
Arya,0,1,0,12,12
Aryan,1,0,29,0,29
Asa,1,0,33,0,33
Åsa,0,1,0,906,906
Asaad,1,0,12,0,12
Asad,0.741935483870968,0.258064516129032,46,16,62
Asarias,1,0,91,0,91
Åse,0,1,0,14,14
Asha,0,1,0,66,66
Asher,1,0,10,0,10
Ashley,0.178571428571429,0.821428571428571,10,46,56
Asho,0,1,0,13,13
Ashraf,0.65625,0.34375,21,11,32
Ashton,1,0,12,0,12
Asia,0,1,0,16,16
Asif,1,0,14,0,14
Asko,1,0,6550,0,6550
Askonpoika,1,0,49,0,49
Askontytär,0,1,0,10,10
Asla,0.91566265060241,0.0843373493975904,152,14,166
Aslak,1,0,1433,0,1433
Aslakki,1,0,11,0,11
Aslan,1,0,103,0,103
Asli,0,1,0,18,18
Aslög,0,1,0,43,43
Asma,0,1,0,70,70
Asmaa,0,1,0,32,32
Asmo,1,0,437,0,437
Aso,1,0,13,0,13
Asra,0,1,0,13,13
Asrin,0,1,0,11,11
Assar,1,0,42,0,42
Assari,1,0,12,0,12
Asse,1,0,12,0,12
Asser,1,0,1935,0,1935
Asseri,1,0,850,0,850
Assi,0,1,0,426,426
Asta,0,1,0,4772,4772
Aster,0,1,0,36,36
Asteri,0,1,0,69,69
Asterix,1,0,13,0,13
Asto,1,0,18,0,18
Aston,1,0,44,0,44
Astor,1,0,29,0,29
Astra,0,1,0,19,19
Astrea,0,1,0,11,11
Astri,0,1,0,24,24
Astrid,0,1,0,2749,2749
Ata,1,0,22,0,22
Atanas,1,0,11,0,11
Ate,1,0,82,0,82
Atef,1,0,16,0,16
Atenpoika,1,0,23,0,23
Athanasios,1,0,11,0,11
Athena,0,1,0,39,39
Athene,0,1,0,28,28
Athina,0,1,0,27,27
Ati,1,0,23,0,23
Atieno,0,1,0,15,15
Atik,1,0,10,0,10
Atilla,1,0,25,0,25
Atlanta,0,1,0,12,12
Atlas,1,0,35,0,35
Atle,1,0,117,0,117
Atos,1,0,19,0,19
Atri,1,0,26,0,26
Atro,1,0,241,0,241
Atso,1,0,694,0,694
Atte,1,0,6504,0,6504
Atte-Oskari,1,0,12,0,12
Atte-Pekka,1,0,10,0,10
Attila,1,0,69,0,69
Audrey,0,1,0,41,41
Auer,1,0,12,0,12
August,1,0,4939,0,4939
Augusta,0,1,0,542,542
Augusti,1,0,365,0,365
Augustiina,0,1,0,28,28
Augustin,1,0,40,0,40
Augustina,0,1,0,14,14
Augustine,1,0,11,0,11
Augustinus,1,0,14,0,14
Augusto,1,0,39,0,39
Augustus,1,0,33,0,33
Auku,1,0,18,0,18
Aukust,1,0,49,0,49
Aukusta,0,1,0,34,34
Aukusti,1,0,9410,0,9410
Aula,0,1,0,44,44
Auli,0.00316670436552816,0.996833295634472,14,4407,4421
Aulikki,0,1,0,11507,11507
Aulis,1,0,13320,0,13320
Aulona,0,1,0,10,10
Aune,0,1,0,10010,10010
Aunetta,0,1,0,11,11
Auni,0,1,0,275,275
Auno,1,0,185,0,185
Aunus,1,0,31,0,31
Aura,0,1,0,1593,1593
Aure,0,1,0,24,24
Aurea,0,1,0,25,25
Aureelia,0,1,0,29,29
Aurel,1,0,11,0,11
Aurelia,0,1,0,836,836
Aurélie,0,1,0,10,10
Aurelio,1,0,25,0,25
Aurelius,1,0,32,0,32
Auri,0.0436241610738255,0.956375838926175,13,285,298
Auriina,0,1,0,25,25
Auringonkukka,0,1,0,10,10
Aurinko,0.107142857142857,0.892857142857143,12,100,112
Auroora,0,1,0,891,891
Aurora,0,1,0,14982,14982
Aurore,0,1,0,12,12
Auruura,0,1,0,15,15
Austin,1,0,27,0,27
Auvikki,0,1,0,30,30
Auvo,0.982861400894188,0.0171385991058122,1319,23,1342
Auvonpoika,1,0,12,0,12
Ava,0,1,0,885,885
Avalon,0,1,0,12,12
Ave,0,1,0,13,13
Avelia,0,1,0,13,13
Aveliina,0,1,0,11,11
Avelina,0,1,0,10,10
Avella,0,1,0,12,12
Avena,0,1,0,11,11
Avi,1,0,11,0,11
Avilla,0,1,0,28,28
Avin,0,1,0,13,13
Aviva,0,1,0,30,30
Avni,1,0,14,0,14
Avraham,1,0,11,0,11
Awa,0,1,0,50,50
Awad,1,0,22,0,22
Aweis,1,0,20,0,20
Awil,0.685714285714286,0.314285714285714,24,11,35
Awuor,0,1,0,10,10
Axa,0,1,0,21,21
Axel,1,0,3486,0,3486
Axeli,1,0,17,0,17
Axelina,0,1,0,29,29
Axl,1,0,41,0,41
Axu,1,0,14,0,14
Aya,0,1,0,46,46
Ayaan,0,1,0,46,46
Ayad,1,0,10,0,10
Ayan,0,1,0,72,72
Ayda,0,1,0,22,22
Ayden,1,0,10,0,10
Aydin,1,0,26,0,26
Aye,0,1,0,12,12
Ayesha,0,1,0,18,18
Ayhan,1,0,18,0,18
Ayla,0,1,0,49,49
Aylin,0,1,0,47,47
Ayman,1,0,51,0,51
Aynur,0,1,0,14,14
Ayoub,1,0,30,0,30
Ayrton,1,0,10,0,10
Ayse,0,1,0,43,43
Aysel,0,1,0,13,13
Aysha,0,1,0,14,14
Ayten,0,1,0,10,10
Ayub,1,0,37,0,37
Ayuub,1,0,29,0,29
Azad,1,0,45,0,45
Aziz,0.788990825688073,0.211009174311927,86,23,109
Aziza,0,1,0,23,23
Azra,0,1,0,37,37
Ba,1,0,25,0,25
Babak,1,0,17,0,17
Babette,0,1,0,14,14
Badal,1,0,10,0,10
Badr,1,0,10,0,10
Bahar,0,1,0,37,37
Bahman,1,0,13,0,13
Bahram,1,0,10,0,10
Bailey,1,0,10,0,10
Bajram,1,0,15,0,15
Bakhtiar,1,0,10,0,10
Bambi,0,1,0,14,14
Bao,0.525,0.475,42,38,80
Baran,1,0,47,0,47
Barbara,0,1,0,344,344
Barbi,0,1,0,12,12
Barbro,0,1,0,1304,1304
Barham,1,0,10,0,10
Baris,1,0,20,0,20
Barita,0,1,0,17,17
Barry,1,0,18,0,18
Bart,1,0,11,0,11
Bashar,1,0,11,0,11
Bashiir,1,0,15,0,15
Bashir,0.654545454545455,0.345454545454545,72,38,110
Bashkim,1,0,10,0,10
Basil,1,0,22,0,22
Basilius,1,0,32,0,32
Basma,0,1,0,10,10
Bassam,1,0,14,0,14
Bastian,1,0,80,0,80
Batu,1,0,15,0,15
Bayram,1,0,24,0,24
Be,0,1,0,10,10
Bea,0,1,0,452,452
Beada,0,1,0,49,49
Beata,0,1,0,811,811
Beate,0,1,0,40,40
Beatrice,0,1,0,1254,1254
Béatrice,0,1,0,14,14
Beatrix,0,1,0,39,39
Beatriz,0,1,0,51,51
Beatta,0,1,0,25,25
Beda,0,1,0,171,171
Bedri,1,0,14,0,14
Beea,0,1,0,45,45
Beeda,0,1,0,76,76
Beerit,0,1,0,31,31
Behzad,1,0,12,0,12
Bekim,1,0,21,0,21
Bekir,1,0,15,0,15
Béla,1,0,19,0,19
Belinda,0,1,0,249,249
Bella,0,1,0,353,353
Belle,0,1,0,15,15
ben,1,0,22,0,22
Ben,1,0,898,0,898
Benedict,1,0,48,0,48
Benedicta,0,1,0,11,11
Benedikt,1,0,46,0,46
Ben-Erik,1,0,13,0,13
Bengt,1,0,2343,0,2343
Bengt-Erik,1,0,36,0,36
Bengt-Göran,1,0,11,0,11
Bengt-Johan,1,0,16,0,16
Bengt-Olof,1,0,16,0,16
Bengtsson,1,0,18,0,18
Benhard,1,0,24,0,24
Beni,1,0,11,0,11
Benina,0,1,0,12,12
Benita,0,1,0,1373,1373
Benito,1,0,14,0,14
Benja,1,0,14,0,14
Benjam,1,0,850,0,850
Benjami,1,0,719,0,719
Benjamin,1,0,9196,0,9196
Benn,1,0,10,0,10
Bennet,1,0,16,0,16
Benno,1,0,15,0,15
Benny,1,0,325,0,325
Bent,0,1,0,26,26
Benyamin,1,0,26,0,26
Berat,1,0,30,0,30
Berfin,0,1,0,43,43
Berit,0,1,0,1452,1452
Berith,0,1,0,29,29
Berivan,0,1,0,19,19
Berk,1,0,17,0,17
Bernadette,0,1,0,21,21
Bernard,1,0,59,0,59
Bernardo,1,0,15,0,15
Bernd,1,0,22,0,22
Berndt,1,0,400,0,400
Bernhard,1,0,1511,0,1511
Bernice,0,1,0,241,241
Bernt,1,0,381,0,381
Bert,1,0,86,0,86
Berta,0,1,0,106,106
Bertel,1,0,990,0,990
Bertelsson,1,0,12,0,12
Bertha,0,1,0,56,56
Berthold,1,0,11,0,11
Bertil,1,0,607,0,607
Bertina,0,1,0,10,10
Bertta,0,1,0,1289,1289
Beryl,0,1,0,17,17
Besart,1,0,13,0,13
Besarta,0,1,0,12,12
Besim,1,0,15,0,15
Besnik,1,0,17,0,17
Beth,0,1,0,16,16
Betina,0,1,0,17,17
Betti,0,1,0,22,22
Bettiina,0,1,0,185,185
Bettina,0,1,0,769,769
Betty,0,1,0,241,241
Bia,0,1,0,13,13
Bianca,0,1,0,340,340
Bibi,0,1,0,24,24
Bich,0,1,0,47,47
Bigga,0,1,0,21,21
Bilaal,1,0,10,0,10
Bilal,1,0,92,0,92
Bile,0.5,0.5,12,12,24
Bill,1,0,57,0,57
Billy,1,0,41,0,41
Bin,1,0,20,0,20
Binh,1,0,33,0,33
Binta,0,1,0,25,25
Biret,0,1,0,12,12
Birger,1,0,1547,0,1547
Birgersson,1,0,20,0,20
Birgetta,0,1,0,58,58
Birgit,0,1,0,3335,3335
Birgitt,0,1,0,19,19
Birgitta,0,1,0,15032,15032
Birgitte,0,1,0,53,53
Birit,0,1,0,69,69
Birita,0,1,0,18,18
Biritta,0,1,0,36,36
Birk,1,0,41,0,41
Birkitta,0,1,0,66,66
Birthe,0,1,0,21,21
Bjarne,1,0,898,0,898
Björn,1,0,1678,0,1678
Bjørn,1,0,13,0,13
Björn-Erik,1,0,36,0,36
Björn-Olof,1,0,26,0,26
Björnsdotter,0,1,0,29,29
Björnson,1,0,23,0,23
Björnsson,1,0,27,0,27
Blake,1,0,20,0,20
Blanca,0,1,0,23,23
Blanka,0,1,0,25,25
Blerim,1,0,11,0,11
Blerina,0,1,0,12,12
Blerta,0,1,0,16,16
Blessing,0,1,0,15,15
Blondine,0,1,0,29,29
Blue,1,0,10,0,10
Bo,1,0,1718,0,1718
Bo-Anders,1,0,18,0,18
Bob,1,0,42,0,42
Bobby,1,0,15,0,15
Bodil,0,1,0,235,235
Boel,0,1,0,21,21
Bo-Erik,1,0,179,0,179
Boes,1,0,13,0,13
Bogdan,1,0,26,0,26
Bo-Göran,1,0,57,0,57
Bo-Gunnar,1,0,12,0,12
Bo-Gustav,1,0,13,0,13
Bo-Håkan,1,0,11,0,11
Bo-Henrik,1,0,10,0,10
Bojan,0,1,0,20,20
Bo-Johan,1,0,17,0,17
Boleslaw,1,0,10,0,10
Bonnie,0,1,0,13,13
Bore,1,0,29,0,29
Borghild,0,1,0,21,21
Boris,1,0,702,0,702
Borisovna,0,1,0,22,22
Börje,1,0,1431,0,1431
Börjesson,1,0,10,0,10
Bosdotter,0,1,0,11,11
Bosson,1,0,11,0,11
Boy,1,0,20,0,20
Bradley,1,0,21,0,21
Brage,1,0,66,0,66
Brahim,1,0,40,0,40
Brandon,1,0,78,0,78
Brenda,0,1,0,38,38
Brendan,1,0,26,0,26
Brett,1,0,16,0,16
Bria,0,1,0,10,10
Brian,1,0,137,0,137
Briana,0,1,0,12,12
Brianna,0,1,0,58,58
Bricella,0,1,0,10,10
Bridget,0,1,0,13,13
Brigitta,0,1,0,37,37
Brigitte,0,1,0,70,70
Briita,0,1,0,43,43
Briitta,0,1,0,595,595
Briitta-Liisa,0,1,0,20,20
Brita,0,1,0,1958,1958
Brita-Liisa,0,1,0,25,25
Brita-Lisa,0,1,0,14,14
Britt,0,1,0,389,389
Britta,0,1,0,798,798
Britt-Helen,0,1,0,17,17
Britt-Inger,0,1,0,37,37
Britt-Louise,0,1,0,49,49
Britt-Maj,0,1,0,23,23
Britt-Mari,0,1,0,170,170
Britt-Marie,0,1,0,408,408
Brooke,0,1,0,16,16
Bror,1,0,1360,0,1360
Bror-Erik,1,0,88,0,88
Bruce,1,0,59,0,59
Bruno,1,0,633,0,633
Bruuno,1,0,46,0,46
Bryan,1,0,35,0,35
Brynhild,0,1,0,12,12
Brynolf,1,0,143,0,143
Bujar,1,0,17,0,17
Bülent,1,0,16,0,16
Burak,1,0,21,0,21
Burhan,1,0,29,0,29
Bushra,0,1,0,27,27
Buster,1,0,15,0,15
Byron,1,0,16,0,16
Caesar,1,0,13,0,13
Cai,1,0,25,0,25
Caisa,0,1,0,21,21
Caisha,0,1,0,11,11
Caitlin,0,1,0,33,33
Caius,1,0,126,0,126
Caj,1,0,261,0,261
Cajsa,0,1,0,81,81
Cajus,1,0,19,0,19
Caleb,1,0,35,0,35
Calista,0,1,0,10,10
Calle,1,0,88,0,88
Callum,1,0,10,0,10
Calvin,1,0,37,0,37
Cam,0,1,0,25,25
Cameron,1,0,55,0,55
Cami,0,1,0,11,11
Camila,0,1,0,39,39
Camilla,0,1,0,5589,5589
Camille,0,1,0,42,42
Camillo,1,0,11,0,11
Camilo,1,0,35,0,35
Campbell,1,0,17,0,17
Can,1,0,90,0,90
Canan,0,1,0,13,13
Candice,0,1,0,11,11
Cao,1,0,14,0,14
Cara,0,1,0,68,68
Caramia,0,1,0,15,15
Carelia,0,1,0,26,26
Caren,0,1,0,11,11
Cariina,0,1,0,24,24
Carin,0,1,0,220,220
Carina,0,1,0,1890,1890
Carine,0,1,0,23,23
Carissa,0,1,0,23,23
Carita,0,1,0,7101,7101
Caritta,0,1,0,16,16
Carl,1,0,4244,0,4244
Carla,0,1,0,330,330
Carl-Anders,1,0,20,0,20
Carl-Anton,1,0,20,0,20
Carl-Axel,1,0,40,0,40
Carl-Christian,1,0,25,0,25
Carl-Emil,1,0,13,0,13
Carl-Eric,1,0,49,0,49
Carl-Erik,1,0,162,0,162
Carl-Fredrik,1,0,23,0,23
Carl-Göran,1,0,21,0,21
Carl-Gustaf,1,0,105,0,105
Carl-Gustav,1,0,160,0,160
Carl-Henrik,1,0,113,0,113
Carl-Johan,1,0,371,0,371
Carl-Magnus,1,0,63,0,63
Carl-Michael,1,0,15,0,15
Carl-Mikael,1,0,37,0,37
Carlo,1,0,158,0,158
Carl-Olof,1,0,29,0,29
Carlos,1,0,286,0,286
Carl-Oscar,1,0,37,0,37
Carl-Oskar,1,0,12,0,12
Carlotta,0,1,0,42,42
Carlsson,1,0,14,0,14
Carl-Victor,1,0,10,0,10
Carl-Wilhelm,1,0,19,0,19
Carmel,0,1,0,16,16
Carmela,0,1,0,98,98
Carmelo,1,0,13,0,13
Carmen,0,1,0,386,386
Caro,0.558823529411765,0.441176470588235,19,15,34
Carol,0.324324324324324,0.675675675675676,24,50,74
Carola,0,1,0,1971,1971
Carole,0,1,0,18,18
Caroliina,0,1,0,284,284
Carolin,0,1,0,116,116
Carolina,0,1,0,1933,1933
Caroline,0,1,0,1089,1089
Carolus,1,0,86,0,86
Carolyn,0,1,0,38,38
Carson,1,0,10,0,10
Carsten,1,0,20,0,20
Cary,1,0,18,0,18
Casandra,0,1,0,94,94
Casey,1,0,12,0,12
Casimir,1,0,599,0,599
Casmir,1,0,17,0,17
Caspar,1,0,72,0,72
Casper,1,0,1364,0,1364
Casperi,1,0,13,0,13
Caspian,1,0,112,0,112
Cassandra,0,1,0,413,413
Cassius,1,0,14,0,14
Castor,1,0,25,0,25
Catalina,0,1,0,63,63
Catariina,0,1,0,36,36
Catarina,0,1,0,585,585
Catarine,0,1,0,10,10
Caterina,0,1,0,97,97
Catharina,0,1,0,690,690
Catharine,0,1,0,28,28
Catherina,0,1,0,31,31
Catherine,0,1,0,388,388
Cathrin,0,1,0,23,23
Cathrina,0,1,0,11,11
Cathrine,0,1,0,92,92
Cathryn,0,1,0,10,10
Cathy,0,1,0,12,12
Catja,0,1,0,11,11
Catriina,0,1,0,14,14
Catrin,0,1,0,104,104
Catrina,0,1,0,32,32
Catrine,0,1,0,103,103
Catriona,0,1,0,19,19
Cay,1,0,86,0,86
Cecil,1,0,31,0,31
Cecile,0,1,0,18,18
Cécile,0,1,0,23,23
Cecilia,0,1,0,4523,4523
Cécilia,0,1,0,14,14
Cecilie,0,1,0,37,37
Cedric,1,0,75,0,75
Cédric,1,0,10,0,10
Cedrik,1,0,31,0,31
Celeste,0,1,0,89,89
Celia,0,1,0,106,106
Celina,0,1,0,236,236
Celinda,0,1,0,50,50
Celine,0,1,0,130,130
Céline,0,1,0,35,35
Cem,1,0,24,0,24
Cemal,1,0,21,0,21
Cemile,0,1,0,10,10
Cengiz,1,0,16,0,16
Cesar,1,0,35,0,35
César,1,0,13,0,13
Cesilia,0,1,0,135,135
Cevin,1,0,19,0,19
Chan,1,0,11,0,11
Chandra,1,0,13,0,13
Chanel,0,1,0,32,32
Chanelle,0,1,0,15,15
Chanette,0,1,0,15,15
Chantal,0,1,0,60,60
Chantelle,0,1,0,17,17
Charlene,0,1,0,25,25
Charles,1,0,542,0,542
Charlie,1,0,129,0,129
Charlot,0,1,0,12,12
Charlott,0,1,0,111,111
Charlotta,0,1,0,3702,3702
Charlotte,0,1,0,1613,1613
Chatarina,0,1,0,61,61
Chatrin,0,1,0,12,12
Chatrine,0,1,0,18,18
Chau,0.368421052631579,0.631578947368421,14,24,38
Chelsea,0,1,0,43,43
Chen,0,1,0,10,10
Cheng,1,0,21,0,21
Cheryl,0,1,0,22,22
Cheyenne,0,1,0,11,11
Chi,0.643835616438356,0.356164383561644,47,26,73
Chia,0,1,0,19,19
Chiamaka,0,1,0,18,18
Chiara,0,1,0,82,82
Chinedu,1,0,11,0,11
Ching,0,1,0,10,10
Chioma,0,1,0,20,20
Chira,0,1,0,10,10
Chloe,0,1,0,81,81
Chloé,0,1,0,42,42
Chris,0.805031446540881,0.19496855345912,128,31,159
Chrisse,0,1,0,11,11
Christa,0,1,0,688,688
Christabel,0,1,0,11,11
Christal,0,1,0,25,25
Christa-Maria,0,1,0,10,10
Christel,0,1,0,703,703
Christell,0,1,0,12,12
Christella,0,1,0,11,11
Christelle,0,1,0,18,18
Christer,1,0,2583,0,2583
Christiaan,1,0,16,0,16
Christian,1,0,9985,0,9985
Christiana,0,1,0,35,35
Christiane,0,1,0,51,51
Christianne,0,1,0,14,14
Christiano,1,0,12,0,12
Christiansdotter,0,1,0,18,18
Christiansson,1,0,12,0,12
Christie,0,1,0,14,14
Christiina,0,1,0,145,145
Christin,0,1,0,226,226
Christina,0,1,0,6834,6834
Christine,0,1,0,2028,2028
Christo,1,0,13,0,13
Christofer,1,0,132,0,132
Christoffer,1,0,1480,0,1480
Christoph,1,0,66,0,66
Christophe,1,0,34,0,34
Christopher,1,0,1036,0,1036
Christos,1,0,37,0,37
Chukwuemeka,1,0,14,0,14
Chun,0.633333333333333,0.366666666666667,19,11,30
Chung,1,0,13,0,13
Cia,0,1,0,170,170
Cian,1,0,17,0,17
Ciara,0,1,0,49,49
Cihan,1,0,10,0,10
Ciia,0,1,0,38,38
Cilla,0,1,0,143,143
Cinderella,0,1,0,10,10
Cindi,0,1,0,10,10
Cindy,0,1,0,198,198
Cira,0,1,0,29,29
Claes,1,0,160,0,160
Claes-Göran,1,0,10,0,10
Claire,0,1,0,98,98
Clara,0,1,0,380,380
Clare,0,1,0,20,20
Clarence,1,0,17,0,17
Clarissa,0,1,0,240,240
Clarisse,0,1,0,21,21
Clark,1,0,20,0,20
Clary,0,1,0,78,78
Clary-Ann,0,1,0,16,16
Clas,1,0,191,0,191
Clas-Göran,1,0,29,0,29
Claude,1,0,39,0,39
Claudia,0,1,0,788,788
Claudine,0,1,0,20,20
Claudio,1,0,59,0,59
Claudius,1,0,17,0,17
Claus,1,0,120,0,120
Clemens,1,0,10,0,10
Clement,1,0,15,0,15
Cleo,0,1,0,12,12
Clifford,1,0,22,0,22
Coco,0,1,0,21,21
Cody,1,0,14,0,14
Cole,1,0,17,0,17
Colette,0,1,0,19,19
Colin,1,0,143,0,143
Collin,1,0,18,0,18
Collins,1,0,10,0,10
Cong,1,0,42,0,42
Connor,1,0,36,0,36
Conny,1,0,274,0,274
Conor,1,0,13,0,13
Conrad,1,0,86,0,86
Constance,0,1,0,75,75
Constantin,1,0,72,0,72
Cooper,1,0,15,0,15
Cora,0,1,0,19,19
Cordelia,0,1,0,11,11
Corina,0,1,0,11,11
Corinna,0,1,0,58,58
Corinne,0,1,0,89,89
Cornelia,0,1,0,154,154
Cornelis,1,0,32,0,32
Cornelius,1,0,29,0,29
Cosmo,1,0,48,0,48
Craig,1,0,24,0,24
Crista,0,1,0,199,199
Cristal,0,1,0,16,16
Cristel,0,1,0,28,28
Crister,1,0,91,0,91
Cristian,1,0,831,0,831
Cristiano,1,0,28,0,28
Cristiina,0,1,0,80,80
Cristin,0,1,0,21,21
Cristina,0,1,0,567,567
Cristine,0,1,0,69,69
Cristofer,1,0,17,0,17
Cristoffer,1,0,34,0,34
Cristopher,1,0,18,0,18
Crystal,0,1,0,28,28
Csaba,1,0,13,0,13
Cuong,1,0,30,0,30
Curt,1,0,168,0,168
Cynthia,0,1,0,32,32
Cyril,1,0,17,0,17
Cyrus,1,0,14,0,14
Da,0,1,0,15,15
Daalia,0,1,0,57,57
Daan,1,0,11,0,11
Daavid,1,0,131,0,131
Dafina,0,1,0,18,18
Dag,1,0,113,0,113
Daga,0,1,0,16,16
Dage,1,0,39,0,39
Dagmar,0,1,0,856,856
Dagny,0,1,0,242,242
Dahir,0.62962962962963,0.37037037037037,51,30,81
Dahlia,0,1,0,46,46
Dai,1,0,18,0,18
Daisy,0,1,0,140,140
Dakota,0,1,0,11,11
Dale,1,0,16,0,16
Dalia,0,1,0,65,65
Dalila,0,1,0,18,18
Dalton,1,0,10,0,10
Damaris,0,1,0,35,35
Damian,1,0,92,0,92
Damien,1,0,120,0,120
Damir,1,0,20,0,20
Damla,0,1,0,27,27
Damon,1,0,20,0,20
Dan,0.993311036789298,0.00668896321070234,1485,10,1495
Dana,0.149350649350649,0.850649350649351,23,131,154
Dan-Anders,1,0,39,0,39
Danel,1,0,12,0,12
Dan-Erik,1,0,51,0,51
Dang,1,0,20,0,20
Dani,1,0,503,0,503
Dania,0,1,0,44,44
Danial,1,0,39,0,39
Danica,0,1,0,24,24
Daniel,0.998863291906638,0.00113670809336162,13181,15,13196
Dániel,1,0,11,0,11
Daniela,0,1,0,2273,2273
Daniéla,0,1,0,11,11
Daniele,1,0,58,0,58
Daniella,0,1,0,184,184
Danielle,0,1,0,124,124
Danielsdotter,0,1,0,11,11
Daniil,1,0,117,0,117
Danika,0,1,0,16,16
Danil,1,0,35,0,35
Danila,1,0,20,0,20
Danilo,1,0,26,0,26
Danja,0,1,0,17,17
Danny,1,0,66,0,66
Dan-Olof,1,0,11,0,11
Dante,1,0,95,0,95
Danuta,0,1,0,19,19
Dany,1,0,20,0,20
Dao,0,1,0,21,21
Daoud,1,0,10,0,10
Daphne,0,1,0,12,12
Dara,0.454545454545455,0.545454545454545,10,12,22
Dardan,1,0,11,0,11
Dareia,0,1,0,11,11
Daria,0,1,0,193,193
Darin,1,0,45,0,45
Darina,0,1,0,31,31
Dario,1,0,46,0,46
Darius,1,0,50,0,50
Dariush,1,0,18,0,18
Darja,0,1,0,126,126
Darlene,0,1,0,10,10
Darling,0,1,0,49,49
Darren,1,0,21,0,21
Darya,0,1,0,16,16
Dastan,1,0,10,0,10
Dat,1,0,28,0,28
Daud,1,0,22,0,22
Dave,1,0,45,0,45
David,1,0,1744,0,1744
Davide,1,0,28,0,28
Davin,1,0,33,0,33
Davina,0,1,0,17,17
Davy,1,0,15,0,15
Dawit,1,0,14,0,14
Dawn,0,1,0,35,35
de,0,1,0,16,16
De,0.363636363636364,0.636363636363636,16,28,44
Dea,0,1,0,47,47
Dean,1,0,77,0,77
Deanna,0,1,0,12,12
Debbie,0,1,0,12,12
Debora,0,1,0,58,58
Deborah,0,1,0,75,75
Decire,0,1,0,15,15
Deciree,0,1,0,10,10
Declan,1,0,11,0,11
Deeqa,0,1,0,15,15
Deeqo,0,1,0,10,10
Defne,0,1,0,11,11
del,0,1,0,29,29
Del,0,1,0,54,54
Delal,0,1,0,12,12
Delia,0,1,0,43,43
Delila,0,1,0,56,56
Della,0,1,0,11,11
Demi,0,1,0,47,47
Demian,1,0,18,0,18
Demir,1,0,19,0,19
Deng,1,0,15,0,15
Deni,1,0,10,0,10
Denice,0,1,0,113,113
Denis,1,0,294,0,294
Denisa,0,1,0,11,11
Denise,0,1,0,302,302
Deniz,0.809815950920245,0.190184049079755,132,31,163
Dennis,1,0,764,0,764
Denny,1,0,12,0,12
Derek,1,0,61,0,61
Derrick,1,0,22,0,22
Derya,0,1,0,32,32
Desideria,0,1,0,17,17
Desire,0,1,0,159,159
Desiré,0,1,0,249,249
Desirè,0,1,0,10,10
Desiree,0,1,0,318,318
Desirée,0,1,0,228,228
Désirée,0,1,0,54,54
Desireé,0,1,0,52,52
Desiren,0,1,0,11,11
Desmond,1,0,25,0,25
Despina,0,1,0,16,16
Destiny,0,1,0,16,16
Devi,0,1,0,14,14
Devin,1,0,30,0,30
Dexter,1,0,20,0,20
Dia,0,1,0,14,14
Diako,1,0,10,0,10
Diana,0,1,0,1147,1147
Diandra,0,1,0,10,10
Diane,0,1,0,53,53
Dianna,0,1,0,15,15
Diar,1,0,36,0,36
Dick,1,0,293,0,293
Didier,1,0,14,0,14
Didrik,1,0,29,0,29
Diego,1,0,96,0,96
Diellza,0,1,0,11,11
Diem,0,1,0,28,28
Diep,0,1,0,10,10
Dieter,1,0,40,0,40
Dietrich,1,0,16,0,16
Dieu,0,1,0,20,20
Diina,0,1,0,17,17
Dilan,0.361702127659574,0.638297872340426,17,30,47
Dilara,0,1,0,37,37
Dilek,0,1,0,16,16
Dima,1,0,18,0,18
Dimi,1,0,11,0,11
Dimitar,1,0,10,0,10
Dimitra,0,1,0,19,19
Dimitri,1,0,645,0,645
Dimitrij,1,0,10,0,10
Dimitrios,1,0,50,0,50
Dimitris,1,0,17,0,17
Din,1,0,11,0,11
Dina,0,1,0,238,238
Dinah,0,1,0,25,25
Dinh,1,0,23,0,23
Dino,1,0,53,0,53
Dion,1,0,30,0,30
Diona,0,1,0,11,11
Dionne,0,1,0,10,10
Dirk,1,0,18,0,18
Disa,0,1,0,302,302
Dita,0,1,0,19,19
Ditte,0,1,0,38,38
Divine,0,1,0,10,10
Diyar,1,0,22,0,22
Dmitri,1,0,221,0,221
Dmitrievna,0,1,0,13,13
Dmitrij,1,0,28,0,28
Dmitriy,1,0,10,0,10
Dmitry,1,0,114,0,114
Dogan,1,0,13,0,13
Dolly,0,1,0,63,63
Dolores,0,1,0,176,176
Dome,1,0,12,0,12
Domenico,1,0,20,0,20
Domingo,1,0,10,0,10
Dominic,1,0,279,0,279
Dominick,1,0,24,0,24
Dominicus,1,0,21,0,21
Dominik,1,0,93,0,93
Dominika,0,1,0,16,16
Dominique,0.433333333333333,0.566666666666667,26,34,60
Domna,0,1,0,19,19
Don,1,0,65,0,65
Donald,1,0,92,0,92
Donata,0,1,0,10,10
Donatus,1,0,12,0,12
Dong,0.478260869565217,0.521739130434783,11,12,23
Doni,1,0,14,0,14
Donia,0,1,0,23,23
Donika,0,1,0,13,13
Donna,0,1,0,79,79
Donya,0,1,0,21,21
Dora,0,1,0,141,141
Doreen,0,1,0,12,12
Dorian,1,0,22,0,22
Doris,0,1,0,899,899
Dorita,0,1,0,44,44
Dorota,0,1,0,14,14
Dorotea,0,1,0,112,112
Dorothea,0,1,0,148,148
Dorothy,0,1,0,53,53
Dorrit,0,1,0,156,156
Dorthe,0,1,0,13,13
Dorthy,0,1,0,21,21
Douglas,1,0,80,0,80
Dounia,0,1,0,10,10
Driss,1,0,26,0,26
Drita,0,1,0,17,17
Duc,1,0,81,0,81
Duncan,1,0,19,0,19
Dung,0.520547945205479,0.479452054794521,38,35,73
Dunia,0,1,0,25,25
Dunja,0,1,0,24,24
Dunya,0,1,0,14,14
Duong,0.615384615384615,0.384615384615385,16,10,26
Duy,1,0,56,0,56
Duyen,0,1,0,18,18
Dylan,1,0,120,0,120
Ea,0,1,0,110,110
Earl,1,0,11,0,11
Ebba,0,1,0,939,939
Ebbe,1,0,56,0,56
Eben,1,0,17,0,17
Ebenezer,1,0,13,0,13
Ebenhard,1,0,21,0,21
Eber,1,0,10,0,10
Eberhard,1,0,16,0,16
Ebrahim,1,0,18,0,18
Ebrima,1,0,19,0,19
Ebru,0,1,0,13,13
Eda,0,1,0,62,62
Edda,0,1,0,51,51
Eddi,1,0,13,0,13
Eddie,1,0,220,0,220
Eddine,1,0,22,0,22
Eddy,1,0,35,0,35
Edel,0.441176470588235,0.558823529411765,15,19,34
Eden,0.079295154185022,0.920704845814978,18,209,227
Edgar,1,0,282,0,282
Edi,1,0,36,0,36
Edil,1,0,10,0,10
Edin,1,0,19,0,19
Edina,0,1,0,34,34
Edison,1,0,11,0,11
Edit,0,1,0,1177,1177
Edita,0,1,0,77,77
Edith,0,1,0,1890,1890
Edla,0,1,0,580,580
Edmond,1,0,26,0,26
Edmund,1,0,88,0,88
Edna,0,1,0,102,102
Edoardo,1,0,15,0,15
Edon,1,0,14,0,14
Edona,0,1,0,26,26
Edouard,1,0,25,0,25
Edson,1,0,10,0,10
Eduard,1,0,170,0,170
Eduardo,1,0,91,0,91
Edvard,1,0,5925,0,5925
Edvart,1,0,91,0,91
Edviina,0,1,0,11,11
Edvin,1,0,2586,0,2586
Edvina,0,1,0,22,22
Edward,1,0,1322,0,1322
Edwart,1,0,10,0,10
Edwin,1,0,343,0,343
Edwina,0,1,0,16,16
Eea,0,1,0,85,85
Eeda,0,1,0,35,35
Eedi,0,1,0,23,23
Eedit,0,1,0,600,600
Eedith,0,1,0,44,44
Eedla,0,1,0,151,151
Eedvard,1,0,24,0,24
Eeka,1,0,131,0,131
Eeki,1,0,57,0,57
Eela,0,1,0,66,66
Eeles,1,0,10,0,10
Eeli,0.996617812852311,0.00338218714768884,3536,12,3548
Eelia,0.45,0.55,18,22,40
Eeliel,1,0,46,0,46
Eelin,0,1,0,168,168
Eelis,1,0,6199,0,6199
Eelo,1,0,10,0,10
Eelovi,1,0,20,0,20
Eelu,1,0,10,0,10
Eemel,1,0,43,0,43
Eemeli,1,0,21715,0,21715
Eemi,1,0,1180,0,1180
Eemil,1,0,11714,0,11714
Eemili,1,0,18,0,18
Eemu,1,0,115,0,115
Eena,0,1,0,39,39
Eeno,1,0,15,0,15
Eenok,1,0,38,0,38
Eenokki,1,0,125,0,125
Eepi,1,0,31,0,31
Eera,1,0,12,0,12
Eeri,0.619047619047619,0.380952380952381,26,16,42
Eerica,0,1,0,58,58
Eerik,1,0,7663,0,7663
Eerika,0,1,0,4853,4853
Eerikki,1,0,2482,0,2482
Eerin,0,1,0,74,74
Eero,1,0,26697,0,26697
Eero-Matti,1,0,28,0,28
Eeronpoika,1,0,114,0,114
Eerontytär,0,1,0,25,25
Eero-Oskari,1,0,10,0,10
Eeropekka,1,0,25,0,25
Eero-Pekka,1,0,98,0,98
Eero-Veikko,1,0,12,0,12
Eeti,0.942424242424242,0.0575757575757576,311,19,330
Eetla,0,1,0,39,39
Eetu,1,0,14169,0,14169
Eetu-Matti,1,0,13,0,13
Eetu-Oskari,1,0,30,0,30
Eetu-Pekka,1,0,39,0,39
Eetu-Petteri,1,0,45,0,45
Eetu-Ville,1,0,13,0,13
Eetvart,1,0,11,0,11
Eetvartti,1,0,29,0,29
Eetvi,1,0,17,0,17
Eeva,0,1,0,29443,29443
Eeva-Helena,0,1,0,30,30
Eeva-Inkeri,0,1,0,14,14
Eeva-Johanna,0,1,0,10,10
Eeva-Kaarina,0,1,0,280,280
Eeva-Kaija,0,1,0,21,21
Eevakaisa,0,1,0,34,34
Eeva-Kaisa,0,1,0,317,317
Eeva-Kristiina,0,1,0,50,50
Eevald,1,0,33,0,33
Eevaleena,0,1,0,53,53
Eeva-Leena,0,1,0,327,327
Eevaliina,0,1,0,11,11
Eeva-Liina,0,1,0,10,10
Eevaliisa,0,1,0,81,81
Eeva-Liisa,0,1,0,3384,3384
Eeva-Lotta,0,1,0,29,29
Eeva-Maaria,0,1,0,14,14
Eeva-Maarit,0,1,0,10,10
Eevamaija,0,1,0,35,35
Eeva-Maija,0,1,0,516,516
Eevamari,0,1,0,24,24
Eeva-Mari,0,1,0,67,67
Eevamaria,0,1,0,54,54
Eeva-Maria,0,1,0,649,649
Eeva-Marja,0,1,0,135,135
Eeva-Marjatta,0,1,0,11,11
Eevantytär,0,1,0,10,10
Eeva-Reetta,0,1,0,15,15
Eeva-Riikka,0,1,0,33,33
Eevariitta,0,1,0,11,11
Eeva-Riitta,0,1,0,318,318
Eeva-Sisko,0,1,0,37,37
Eeva-Sofia,0,1,0,18,18
Eevastiina,0,1,0,161,161
Eeva-Stiina,0,1,0,80,80
Eevert,1,0,2153,0,2153
Eevertti,1,0,909,0,909
Eevi,0,1,0,3940,3940
Eevi-Maria,0,1,0,11,11
Eewert,1,0,13,0,13
Efe,1,0,48,0,48
Effi,0,1,0,37,37
Effia,0,1,0,33,33
Efia,0,1,0,14,14
Efosa,1,0,11,0,11
Efraim,1,0,150,0,150
Ege,1,0,16,0,16
Egert,1,0,13,0,13
Egil,1,0,153,0,153
Egon,1,0,60,0,60
Egor,1,0,35,0,35
Egzon,1,0,21,0,21
Egzona,0,1,0,20,20
Eha,0,1,0,13,13
Ehsan,1,0,16,0,16
Eija,0,1,0,22207,22207
Eija-Anneli,0,1,0,11,11
Eija-Elina,0,1,0,11,11
Eija-Helena,0,1,0,10,10
Eija-Inkeri,0,1,0,39,39
Eija-Kaarina,0,1,0,21,21
Eija-Leena,0,1,0,102,102
Eija-Liisa,0,1,0,561,561
Eija-Maarit,0,1,0,21,21
Eija-Maija,0,1,0,22,22
Eija-Maria,0,1,0,18,18
Eija-Marja,0,1,0,11,11
Eija-Riitta,0,1,0,205,205
Eija-Sinikka,0,1,0,45,45
Eija-Sisko,0,1,0,16,16
Eijo,1,0,13,0,13
Eikka,1,0,154,0,154
Eila,0,1,0,25150,25150
Eila-Kaarina,0,1,0,10,10
Eila-Maija,0,1,0,30,30
Eila-Maria,0,1,0,12,12
Eila-Sisko,0,1,0,11,11
Eile,0,1,0,11,11
Eileen,0,1,0,45,45
Eiler,1,0,32,0,32
Eilert,1,0,11,0,11
Eili,0,1,0,41,41
Eilo,1,0,63,0,63
Eimi,0,1,0,110,110
Eina,0,1,0,13,13
Einar,1,0,2079,0,2079
Einari,1,0,10861,0,10861
Eine,0,1,0,2572,2572
Eini,0,1,0,1907,1907
Einikki,0,1,0,39,39
Eino,1,0,20202,0,20202
Einojuhani,1,0,10,0,10
Eino-Juhani,1,0,21,0,21
Einonpoika,1,0,13,0,13
Eino-Pekka,1,0,20,0,20
Eino-Veikko,1,0,10,0,10
Eira,0,1,0,4058,4058
Eirene,0,1,0,12,12
Eiri,0,1,0,31,31
Eiric,1,0,10,0,10
Eirik,1,0,134,0,134
Eirin,0,1,0,12,12
Eivor,0,1,0,656,656
Eja,0,1,0,44,44
Ejnar,1,0,16,0,16
Ejvind,1,0,26,0,26
Ejvor,0,1,0,18,18
Eka,1,0,13,0,13
Ekaterina,0,1,0,571,571
Ekaterini,0,1,0,17,17
Eki,1,0,113,0,113
Ekke,1,0,16,0,16
Ekko,1,0,10,0,10
Ekku,1,0,86,0,86
Ekrem,1,0,16,0,16
El,1,0,79,0,79
Ela,0,1,0,37,37
Elaine,0,1,0,72,72
Elaisa,0,1,0,10,10
Elanor,0,1,0,57,57
Elbe,0,1,0,20,20
Elda,0,1,0,17,17
Eldar,1,0,10,0,10
Eldin,1,0,20,0,20
Ele,1,0,13,0,13
Elea,0,1,0,464,464
Eleana,0,1,0,11,11
Eleanoora,0,1,0,71,71
Eleanor,0,1,0,170,170
Eleanora,0,1,0,126,126
Eleasar,1,0,10,0,10
Eleena,0,1,0,56,56
Elektra,0,1,0,24,24
Elen,0,1,0,21,21
Elena,0,1,0,4492,4492
Eléna,0,1,0,13,13
Elene,0,1,0,33,33
Eleni,0,1,0,90,90
Elenor,0,1,0,35,35
Elenora,0,1,0,11,11
Eleonoora,0,1,0,1218,1218
Eleonor,0,1,0,63,63
Eleonora,0,1,0,1179,1179
Eleonore,0,1,0,40,40
Eléonore,0,1,0,10,10
Elfiina,0,1,0,15,15
Elfrida,0,1,0,29,29
Elga,0,1,0,12,12
Elham,0,1,0,13,13
Eli,1,0,60,0,60
Elia,1,0,920,0,920
Eliah,1,0,42,0,42
Elian,1,0,132,0,132
Eliana,0,1,0,96,96
Eliane,0,1,0,17,17
Elias,1,0,23112,0,23112
Elice,0,1,0,143,143
Elicia,0,1,0,14,14
Elida,0,1,0,152,152
Elie,1,0,18,0,18
Eliel,1,0,2082,0,2082
Elieser,1,0,16,0,16
Elif,0,1,0,82,82
Eliida,0,1,0,28,28
Eliina,0,1,0,3458,3458
Eliisa,0,1,0,7394,7394
Eliisabet,0,1,0,233,233
Eliisabeth,0,1,0,19,19
Eliise,0,1,0,100,100
Eliisi,0,1,0,81,81
Elijah,1,0,92,0,92
Elijas,1,0,40,0,40
Elin,0,1,0,1781,1781
Elina,0,1,0,64496,64496
Elina-Maria,0,1,0,19,19
Elinda,0,1,0,22,22
Eline,0,1,0,54,54
Elinor,0,1,0,105,105
Elio,1,0,10,0,10
Eliot,1,0,129,0,129
Eliott,1,0,10,0,10
Elis,1,0,1409,0,1409
Elisa,0,1,0,18964,18964
Elisabet,0,1,0,26969,26969
Elisabeth,0,1,0,18946,18946
Elisabetta,0,1,0,16,16
Elisa-Maria,0,1,0,10,10
Elisaveta,0,1,0,25,25
Elise,0,1,0,4775,4775
Elisi,0,1,0,47,47
Elisia,0,1,0,18,18
Elissa,0,1,0,156,156
Elisse,0,1,0,10,10
Elita,0,1,0,13,13
Eliza,0,1,0,72,72
Elizabet,0,1,0,33,33
Elizabeth,0,1,0,1021,1021
Elizaveta,0,1,0,140,140
Elja,1,0,202,0,202
Eljas,1,0,2578,0,2578
Elke,0,1,0,28,28
Ella,0,1,0,12737,12737
Ella-Emilia,0,1,0,11,11
Ella-Kaisa,0,1,0,15,15
Ella-Maaria,0,1,0,27,27
Ella-Maija,0,1,0,40,40
Ellamari,0,1,0,43,43
Ella-Mari,0,1,0,58,58
Ellamaria,0,1,0,34,34
Ella-Maria,0,1,0,198,198
Ellan,0,1,0,21,21
Ellanoora,0,1,0,50,50
Ella-Noora,0,1,0,60,60
Ella-Olivia,0,1,0,11,11
Ella-Riikka,0,1,0,10,10
Ellariina,0,1,0,17,17
Ella-Riina,0,1,0,13,13
Ella-Roosa,0,1,0,18,18
Ella-Sofia,0,1,0,55,55
Elle,0,1,0,1141,1141
Ellen,0,1,0,9632,9632
Elleni,0,1,0,18,18
Ellert,1,0,12,0,12
Ellevi,0,1,0,31,31
Elli,0,1,0,9886,9886
Ellida,0,1,0,152,152
Ellie,0,1,0,102,102
Elliida,0,1,0,57,57
Elli-Ilona,0,1,0,12,12
Elliina,0,1,0,92,92
Ellika,0,1,0,13,13
Ellimaija,0,1,0,35,35
Elli-Maija,0,1,0,67,67
Ellimari,0,1,0,22,22
Elli-Mari,0,1,0,25,25
Ellimaria,0,1,0,27,27
Elli-Maria,0,1,0,70,70
Elli-Marja,0,1,0,10,10
Ellinoora,0,1,0,850,850
Elli-Noora,0,1,0,273,273
Ellinor,0,1,0,435,435
Ellinora,0,1,0,54,54
Elli-Nora,0,1,0,10,10
Ellinore,0,1,0,17,17
Elliot,1,0,662,0,662
Elliott,1,0,43,0,43
Ellis,0.448275862068966,0.551724137931034,13,16,29
Elli-Sofia,0,1,0,26,26
Elly,0,1,0,97,97
Elma,0,1,0,2618,2618
Elmar,1,0,62,0,62
Elmedina,0,1,0,10,10
Elmer,1,0,806,0,806
Elmeri,1,0,8133,0,8133
Elmi,0.0833333333333333,0.916666666666667,27,297,324
Elmiina,0,1,0,540,540
Elmiira,0,1,0,52,52
Elmina,0,1,0,20,20
Elmira,0,1,0,33,33
Elmo,1,0,1548,0,1548
Elna,0,1,0,1016,1016
Elna-Maria,0,1,0,12,12
Elo,0.970326409495549,0.029673590504451,327,10,337
Elof,1,0,292,0,292
Eloisa,0,1,0,62,62
Eloise,0,1,0,34,34
Elon,1,0,39,0,39
Elona,0,1,0,25,25
Eloni,0,1,0,26,26
Elouise,0,1,0,11,11
Elpi,0,1,0,14,14
Elsa,0,1,0,10076,10076
Elsa-Maija,0,1,0,17,17
Elsa-Maria,0,1,0,51,51
Elsayed,1,0,19,0,19
Elsbet,0,1,0,18,18
Elsbeth,0,1,0,44,44
Else,0,1,0,1522,1522
Else-Britt,0,1,0,16,16
Else-Mai,0,1,0,14,14
Else-Maj,0,1,0,507,507
Else-May,0,1,0,44,44
Elsi,0,1,0,1661,1661
Elsie,0,1,0,162,162
Elsiina,0,1,0,14,14
Elsi-Maj,0,1,0,10,10
Elsmaj,0,1,0,17,17
Els-Maj,0,1,0,36,36
Elssi,0,1,0,10,10
Elton,1,0,87,0,87
Elva,0,1,0,14,14
Elvi,0,1,0,5403,5403
Elvia,0,1,0,27,27
Elviina,0,1,0,29,29
Elviira,0,1,0,3590,3590
Elvin,1,0,69,0,69
Elvina,0,1,0,50,50
Elvine,0,1,0,13,13
Elvira,0,1,0,1374,1374
Elvis,1,0,248,0,248
Elvy,0,1,0,13,13
Elwa,0,1,0,16,16
Elwiira,0,1,0,14,14
Elwin,1,0,12,0,12
Elwira,0,1,0,15,15
Elyas,1,0,14,0,14
Elza,0,1,0,28,28
Elzbieta,0,1,0,18,18
Ema,0,1,0,13,13
Emad,1,0,18,0,18
Eman,0,1,0,12,12
Emanuel,1,0,997,0,997
Emanuela,0,1,0,12,12
Emanuele,1,0,11,0,11
Embla,0,1,0,14,14
Emeka,1,0,17,0,17
Emel,0.5,0.5,12,12,24
Emeli,0,1,0,12,12
Emelia,0,1,0,252,252
Emelie,0,1,0,735,735
Emeliina,0,1,0,131,131
Emelina,0,1,0,48,48
Emeline,0,1,0,20,20
Emely,0,1,0,20,20
Emerentia,0,1,0,93,93
Emerik,1,0,137,0,137
Emerson,1,0,10,0,10
Emi,0,1,0,27,27
Emiel,1,0,15,0,15
Emiilia,0,1,0,117,117
Emiina,0,1,0,14,14
Emil,1,0,15434,0,15434
Émil,1,0,11,0,11
Emila,0,1,0,21,21
Emile,1,0,44,0,44
Emili,0,1,0,106,106
Emilia,0,1,0,64150,64150
Emilian,1,0,11,0,11
Emiliana,0,1,0,11,11
Emiliano,1,0,24,0,24
Emilie,0,1,0,580,580
Emilié,0,1,0,10,10
Emilii,0,1,0,19,19
Emiliina,0,1,0,27,27
Emilija,0,1,0,33,33
Emilio,1,0,232,0,232
Emilja,0,1,0,105,105
Emilla,0,1,0,51,51
Emily,0,1,0,674,674
Emin,1,0,52,0,52
Emina,0,1,0,76,76
Emine,0,1,0,83,83
Emir,1,0,97,0,97
Emira,0,1,0,14,14
Emma,0,1,0,15408,15408
Emma-Julia,0,1,0,17,17
Emmakaisa,0,1,0,11,11
Emma-Kaisa,0,1,0,39,39
Emma-Karoliina,0,1,0,13,13
Emmaleena,0,1,0,23,23
Emma-Leena,0,1,0,37,37
Emmaliina,0,1,0,58,58
Emma-Liina,0,1,0,24,24
Emmaliisa,0,1,0,10,10
Emma-Liisa,0,1,0,36,36
Emmalotta,0,1,0,17,17
Emma-Lotta,0,1,0,89,89
Emma-Maria,0,1,0,44,44
Emma-Noora,0,1,0,13,13
Emmanuel,1,0,221,0,221
Emmanuelle,0,1,0,23,23
Emmanuil,1,0,12,0,12
Emma-Reetta,0,1,0,15,15
Emma-Riikka,0,1,0,20,20
Emma-Roosa,0,1,0,11,11
Emma-Sofia,0,1,0,101,101
Emmastiina,0,1,0,18,18
Emmeli,0,1,0,11,11
Emmelie,0,1,0,39,39
Emmeliina,0,1,0,12,12
Emmeline,0,1,0,12,12
Emmett,1,0,11,0,11
Emmi,0,1,0,9677,9677
Emmie,0,1,0,28,28
Emmiina,0,1,0,596,596
Emmi-Julia,0,1,0,22,22
Emmi-Kaisa,0,1,0,29,29
Emmi-Karoliina,0,1,0,11,11
Emmi-Leena,0,1,0,18,18
Emmi-Liina,0,1,0,12,12
Emmilotta,0,1,0,18,18
Emmi-Lotta,0,1,0,91,91
Emmi-Maria,0,1,0,55,55
Emmi-Noora,0,1,0,26,26
Emmi-Riikka,0,1,0,18,18
Emmi-Sofia,0,1,0,67,67
Emmy,0,1,0,227,227
Emppu,1,0,111,0,111
Emrah,1,0,20,0,20
Emran,1,0,12,0,12
Emre,1,0,127,0,127
Emriikka,0,1,0,13,13
Emrik,1,0,12,0,12
Ena,0,1,0,16,16
Enar,1,0,11,0,11
Endrit,1,0,10,0,10
Ene,0,1,0,30,30
Enea,0,1,0,12,12
Ener,1,0,10,0,10
Enes,1,0,32,0,32
Engelbert,1,0,140,0,140
Engelbrekt,1,0,42,0,42
Engeliina,0,1,0,13,13
Engin,1,0,11,0,11
Engla,0,1,0,103,103
Enia,0,1,0,42,42
Enid,0,1,0,25,25
Enis,1,0,26,0,26
Enisa,0,1,0,13,13
Enja,0,1,0,126,126
Enna,0,1,0,1037,1037
Enne,0,1,0,152,152
Enneli,0,1,0,38,38
Enne-Liisa,0,1,0,27,27
Enni,0,1,0,5090,5090
Enniina,0,1,0,30,30
Ennika,0,1,0,18,18
Enni-Lotta,0,1,0,13,13
Enni-Maija,0,1,0,10,10
Enni-Maria,0,1,0,34,34
Ennio,1,0,11,0,11
Enni-Sofia,0,1,0,17,17
Enny,0,1,0,19,19
Enok,1,0,102,0,102
Enrica,0,1,0,19,19
Enrico,1,0,63,0,63
Enrik,1,0,13,0,13
Enrika,0,1,0,20,20
Enrique,1,0,76,0,76
Ensar,1,0,14,0,14
Ensi,0.388888888888889,0.611111111111111,84,132,216
Ensio,1,0,31363,0,31363
Ensiö,1,0,58,0,58
Enso,1,0,20,0,20
Ensti,1,0,25,0,25
Enver,1,0,33,0,33
Enya,0,1,0,75,75
Enzio,1,0,30,0,30
Enzo,1,0,71,0,71
Eppu,0.982238010657194,0.0177619893428064,553,10,563
Erasmus,1,0,51,0,51
Erda,0,1,0,11,11
Erdal,1,0,15,0,15
Erdem,1,0,10,0,10
Ere,1,0,76,0,76
Eren,1,0,37,0,37
Erfan,1,0,15,0,15
Erhan,1,0,10,0,10
Erhard,1,0,65,0,65
Eric,1,0,1855,0,1855
Erica,0,1,0,1915,1915
Erich,1,0,87,0,87
Erick,1,0,32,0,32
Eriika,0,1,0,620,620
Eriikka,0,1,0,337,337
Erik,1,0,24943,0,24943
Erika,0,1,0,9227,9227
Erikka,0,1,0,34,34
Eriksdotter,0,1,0,16,16
Erin,0,1,0,1157,1157
Erina,0,1,0,38,38
Erita,0,1,0,10,10
Erja,0,1,0,5817,5817
Erja-Leena,0,1,0,38,38
Erja-Liisa,0,1,0,59,59
Erja-Riitta,0,1,0,40,40
Erjo,1,0,10,0,10
Erkan,1,0,31,0,31
Erkinpoika,1,0,136,0,136
Erkintytär,0,1,0,35,35
Erkka,1,0,1046,0,1046
Erkka-Pekka,1,0,15,0,15
Erkki,1,0,37017,0,37017
Erkki-Juhani,1,0,19,0,19
Erkki-Jussi,1,0,14,0,14
Erkki-Mikael,1,0,26,0,26
Erkki-Pekka,1,0,15,0,15
Erkko,1,0,387,0,387
Erko,1,0,17,0,17
Erla,0,1,0,10,10
Erland,1,0,629,0,629
Erling,1,0,123,0,123
Ermo,1,0,78,0,78
Erna,0,1,0,401,401
Erne,1,0,10,0,10
Ernest,1,0,232,0,232
Ernesti,1,0,342,0,342
Ernestine,0,1,0,22,22
Ernesto,1,0,108,0,108
Ernfrid,1,0,111,0,111
Erni,1,0,11,0,11
Erno,1,0,1672,0,1672
Ernst,1,0,637,0,637
Erol,1,0,41,0,41
Eros,1,0,15,0,15
Erpo,1,0,58,0,58
Ertta,0,1,0,17,17
Erva,0,1,0,10,10
Ervin,1,0,37,0,37
Ervo,1,0,60,0,60
Erwin,1,0,44,0,44
Erza,0,1,0,16,16
Esa,1,0,20598,0,20598
Esaias,1,0,482,0,482
Esajas,1,0,21,0,21
Esa-Jussi,1,0,13,0,13
Esam,1,0,13,0,13
Esamatti,1,0,14,0,14
Esa-Matti,1,0,160,0,160
Esanpoika,1,0,111,0,111
Esantytär,0,1,0,36,36
Esapekka,1,0,19,0,19
Esa-Pekka,1,0,321,0,321
Esa-Petri,1,0,13,0,13
Esa-Petteri,1,0,23,0,23
Esa-Tapio,1,0,13,0,13
Esbjörn,1,0,10,0,10
Esikko,0,1,0,23,23
Eskeli,1,0,21,0,21
Eskil,1,0,274,0,274
Esko,1,0,20480,0,20480
Esko-Juhani,1,0,11,0,11
Eskonpoika,1,0,65,0,65
Eskontytär,0,1,0,19,19
Esma,0,1,0,42,42
Esmail,1,0,11,0,11
Esme,0,1,0,37,37
Esmeralda,0,1,0,182,182
Espen,1,0,26,0,26
Esperanza,0,1,0,23,23
Esra,0.220779220779221,0.779220779220779,17,60,77
Essi,0,1,0,7011,7011
Essie,0,1,0,10,10
Essi-Emilia,0,1,0,16,16
Essiina,0,1,0,15,15
Essi-Lotta,0,1,0,14,14
Essi-Maria,0,1,0,52,52
Esteban,1,0,36,0,36
Estel,0,1,0,13,13
Estela,0,1,0,10,10
Estella,0,1,0,196,196
Estelle,0,1,0,264,264
Ester,0,1,0,5407,5407
Esteri,0,1,0,7882,7882
Esteriina,0,1,0,42,42
Esther,0,1,0,286,286
Esti,0,1,0,23,23
Estrid,0,1,0,175,175
Esu,1,0,18,0,18
Eszter,0,1,0,11,11
Etel,0,1,0,316,316
Ethan,1,0,109,0,109
Ethel,0,1,0,366,366
Etienne,1,0,20,0,20
Etna,0,1,0,19,19
Etta,0,1,0,79,79
Etti,0,1,0,70,70
Etvi,1,0,13,0,13
Eudokia,0,1,0,14,14
Eufemia,0,1,0,158,158
Eufrosyne,0,1,0,105,105
Eugen,1,0,585,0,585
Eugén,1,0,66,0,66
Eugene,1,0,44,0,44
Eugenia,0,1,0,106,106
Eugenie,0,1,0,36,36
Eugénie,0,1,0,10,10
Eugenio,1,0,12,0,12
Eulaalia,0,1,0,14,14
Eulalia,0,1,0,25,25
Eunice,0,1,0,30,30
Eva,0,1,0,6051,6051
Eva-Britt,0,1,0,14,14
Eva-Christina,0,1,0,15,15
Eva-Helena,0,1,0,13,13
Eva-Kaarina,0,1,0,36,36
Eva-Kaisa,0,1,0,11,11
Eva-Kristina,0,1,0,13,13
Evald,1,0,614,0,614
Eva-Leena,0,1,0,14,14
Eva-Lena,0,1,0,33,33
Eva-Liisa,0,1,0,170,170
Eva-Lisa,0,1,0,73,73
Eva-Lotta,0,1,0,62,62
Eva-Maija,0,1,0,39,39
Eva-Maj,0,1,0,11,11
Eva-Mari,0,1,0,22,22
Evamaria,0,1,0,18,18
Eva-Maria,0,1,0,321,321
Eva-Marie,0,1,0,49,49
Eva-Marja,0,1,0,15,15
Evan,1,0,102,0,102
Evangelia,0,1,0,19,19
Evangelina,0,1,0,11,11
Evangeline,0,1,0,21,21
Evangelos,1,0,22,0,22
Evanna,0,1,0,10,10
Eva-Riitta,0,1,0,17,17
Eva-Sofia,0,1,0,10,10
Evastiina,0,1,0,20,20
Evastina,0,1,0,15,15
Eva-Stina,0,1,0,74,74
Eve,0,1,0,542,542
Eveli,0,1,0,12,12
Evelia,0,1,0,108,108
Eveliina,0,1,0,25918,25918
Evelin,0,1,0,182,182
Evelina,0,1,0,1032,1032
Eveline,0,1,0,80,80
Evella,0,1,0,17,17
Evely,0,1,0,11,11
Evelyn,0,1,0,288,288
Evelyne,0,1,0,13,13
Even,1,0,10,0,10
Evena,0,1,0,44,44
Everett,1,0,10,0,10
Everi,1,0,10,0,10
Evert,1,0,2099,0,2099
Evertti,1,0,24,0,24
Evgeni,1,0,42,0,42
Evgenia,0,1,0,108,108
Evgenija,0,1,0,20,20
Evgeniya,0,1,0,13,13
Evgeny,1,0,86,0,86
Evgueni,1,0,24,0,24
Evguenia,0,1,0,22,22
Evi,0,1,0,312,312
Evia,0,1,0,22,22
Evian,0,1,0,14,14
Evianna,0,1,0,16,16
Evie,0,1,0,23,23
Evilda,0,1,0,11,11
Evilla,0,1,0,10,10
Evin,0,1,0,44,44
Evind,1,0,11,0,11
Evita,0,1,0,331,331
Evy,0,1,0,87,87
Ewa,0,1,0,120,120
Ewald,1,0,35,0,35
Ewan,1,0,20,0,20
Ewelina,0,1,0,11,11
Ewert,1,0,37,0,37
Exenia,0,1,0,18,18
Eyal,1,0,11,0,11
Eyolf,1,0,25,0,25
Eyvind,1,0,10,0,10
Eyvor,0,1,0,37,37
Ezekiel,1,0,18,0,18
Ezra,1,0,26,0,26
Faadumo,0,1,0,19,19
Fabian,1,0,553,0,553
Fabienne,0,1,0,10,10
Fabio,1,0,26,0,26
Fabiola,0,1,0,11,11
Fadel,1,0,15,0,15
Fadhil,1,0,10,0,10
Fadi,1,0,24,0,24
Fadil,1,0,22,0,22
Faduma,0,1,0,21,21
Fadumo,0,1,0,131,131
Fahad,1,0,19,0,19
Fahim,1,0,18,0,18
Faik,1,0,10,0,10
Faina,0,1,0,51,51
Faisa,0,1,0,29,29
Faisal,0.757894736842105,0.242105263157895,72,23,95
Faith,0,1,0,40,40
Faiza,0,1,0,18,18
Fakher,0,1,0,10,10
Falah,1,0,12,0,12
Familia,0,1,0,13,13
Fang,0,1,0,10,10
Fanni,0,1,0,2334,2334
Fannie,0,1,0,11,11
Fanniina,0,1,0,15,15
Fanni-Maria,0,1,0,10,10
Fanni-Sofia,0,1,0,17,17
Fanny,0,1,0,2759,2759
Fanny-Maria,0,1,0,18,18
Farah,0.432584269662921,0.567415730337079,77,101,178
Farahnaz,0,1,0,10,10
Fardowsa,0,1,0,33,33
Fares,1,0,10,0,10
Farhad,1,0,27,0,27
Farhan,1,0,33,0,33
Farhia,0,1,0,33,33
Farhio,0,1,0,12,12
Farhiya,0,1,0,11,11
Farhiyo,0,1,0,18,18
Fariba,0,1,0,17,17
Farid,1,0,44,0,44
Farida,0,1,0,31,31
Farina,0,1,0,22,22
Faris,1,0,15,0,15
Farouk,1,0,11,0,11
Fartun,0,1,0,20,20
Faruk,1,0,32,0,32
Farzad,1,0,10,0,10
Fatah,1,0,11,0,11
Fatema,0,1,0,19,19
Fatemeh,0,1,0,29,29
Fathi,0.458333333333333,0.541666666666667,11,13,24
Fatih,1,0,34,0,34
Fatima,0,1,0,325,325
Fatimah,0,1,0,11,11
Fatime,0,1,0,16,16
Fatma,0,1,0,87,87
Fatmir,1,0,22,0,22
Fatmire,0,1,0,16,16
Faton,1,0,13,0,13
Fatou,0,1,0,34,34
Fatuma,0,1,0,11,11
Fawzi,1,0,10,0,10
Fay,0,1,0,31,31
Faye,0,1,0,20,20
Faysal,1,0,27,0,27
Febe,0,1,0,24,24
Federica,0,1,0,16,16
Federico,1,0,40,0,40
Fedja,1,0,18,0,18
Fedor,1,0,24,0,24
Feeli,1,0,37,0,37
Feelia,0,1,0,13,13
Feeliks,1,0,72,0,72
Feelix,1,0,22,0,22
Feeti,1,0,10,0,10
Feetu,1,0,58,0,58
Fehmi,1,0,10,0,10
Fei,0,1,0,22,22
Feija,1,0,44,0,44
Felia,0,1,0,10,10
Felice,0,1,0,12,12
Felicia,0,1,0,936,936
Felicitas,0,1,0,10,10
Felicity,0,1,0,12,12
Feliks,1,0,250,0,250
Felipe,1,0,68,0,68
Felix,1,0,1689,0,1689
Félix,1,0,17,0,17
Fen,0,1,0,12,12
Fenix,1,0,16,0,16
Feodor,1,0,92,0,92
Feodosia,0,1,0,13,13
Ferdinand,1,0,648,0,648
Ferenc,1,0,19,0,19
Fereshteh,0,1,0,14,14
Ferhat,1,0,24,0,24
Feride,0,1,0,20,20
Fernanda,0,1,0,30,30
Fernando,1,0,111,0,111
Fevzi,1,0,10,0,10
Fia,0,1,0,220,220
Fidel,1,0,20,0,20
Fiia,0,1,0,496,496
Fiina,0,1,0,122,122
Fiinu,0,1,0,48,48
Fikret,1,0,15,0,15
Filemon,1,0,161,0,161
Filip,1,0,1017,0,1017
Filipe,1,0,14,0,14
Filiph,1,0,12,0,12
Filipp,1,0,40,0,40
Filippa,0,1,0,325,325
Filippo,1,0,28,0,28
Filippus,1,0,30,0,30
Filiz,0,1,0,13,13
Filomena,0,1,0,12,12
Filsan,0,1,0,15,15
Fina,0,1,0,14,14
Fingal,1,0,18,0,18
Finlay,1,0,15,0,15
Finley,1,0,14,0,14
Finn,1,0,158,0,158
Fiona,0,1,0,775,775
Fionn,1,0,19,0,19
Firas,1,0,18,0,18
Firat,1,0,16,0,16
Fitim,1,0,12,0,12
Fitore,0,1,0,13,13
Fjalar,1,0,294,0,294
Fjodor,1,0,10,0,10
Flavio,1,0,10,0,10
Flego,1,0,10,0,10
Floora,0,1,0,21,21
Flora,0,1,0,74,74
Florence,0,1,0,98,98
Florencia,0,1,0,12,12
Florent,1,0,11,0,11
Florentin,1,0,27,0,27
Florentina,0,1,0,23,23
Florian,1,0,74,0,74
Floyd,1,0,10,0,10
Folke,1,0,413,0,413
Folkern,1,0,13,0,13
Fouad,1,0,38,0,38
Fowsia,0,1,0,12,12
Fox,1,0,12,0,12
Frances,0,1,0,74,74
Francesca,0,1,0,148,148
Francesco,1,0,93,0,93
Francilia,0,1,0,11,11
Francine,0,1,0,18,18
Francis,1,0,150,0,150
Francisca,0,1,0,36,36
Francisco,1,0,116,0,116
Franciska,0,1,0,36,36
Franck,1,0,12,0,12
Franco,1,0,30,0,30
Francois,1,0,27,0,27
François,1,0,21,0,21
Francoise,0,1,0,13,13
Françoise,0,1,0,10,10
Frank,1,0,687,0,687
Franklin,1,0,27,0,27
Frans,1,0,3382,0,3382
Frans-Emil,1,0,24,0,24
Fransesca,0,1,0,11,11
Franseska,0,1,0,10,10
Fransiina,0,1,0,116,116
Fransilia,0,1,0,42,42
Fransilja,0,1,0,17,17
Fransina,0,1,0,34,34
Fransisca,0,1,0,15,15
Fransiska,0,1,0,41,41
Franz,1,0,145,0,145
Franziska,0,1,0,58,58
Fred,1,0,210,0,210
Freddie,1,0,25,0,25
Freddy,1,0,45,0,45
Frederic,1,0,19,0,19
Frédéric,1,0,22,0,22
Frederick,1,0,89,0,89
Frederik,1,0,89,0,89
Frederika,0,1,0,38,38
Fredi,1,0,10,0,10
Fredric,1,0,86,0,86
Fredrica,0,1,0,55,55
Fredrick,1,0,40,0,40
Fredriika,0,1,0,120,120
Fredriikka,0,1,0,99,99
Fredrik,1,0,5067,0,5067
Fredrika,0,1,0,1199,1199
Fredrikki,1,0,10,0,10
Fredriksdotter,0,1,0,20,20
Freia,0,1,0,15,15
Freija,0,1,0,57,57
Frej,1,0,258,0,258
Freja,0,1,0,246,246
Frejvid,1,0,39,0,39
Frey,1,0,43,0,43
Freya,0,1,0,119,119
Freyja,0,1,0,20,20
Frida,0,1,0,1598,1598
Frida-Maria,0,1,0,10,10
Fride,1,0,31,0,31
Frideborg,0,1,0,44,44
Fridolf,1,0,146,0,146
Fridolin,1,0,13,0,13
Frieda,0,1,0,13,13
Friederike,0,1,0,10,10
Friedrich,1,0,84,0,84
Friia,0,1,0,14,14
Friida,0,1,0,106,106
Frithiof,1,0,51,0,51
Fritiof,1,0,91,0,91
Fritjof,1,0,56,0,56
Frits,1,0,12,0,12
Fritz,1,0,87,0,87
Fu,0,1,0,16,16
Fuaad,1,0,11,0,11
Fuad,0.705882352941177,0.294117647058824,48,20,68
Fuat,1,0,10,0,10
Furkan,1,0,23,0,23
Gaabriel,1,0,31,0,31
Gabor,1,0,10,0,10
Gábor,1,0,12,0,12
Gabriel,1,0,2916,0,2916
Gabriela,0,1,0,340,340
Gabriele,0.473684210526316,0.526315789473684,18,20,38
Gabriella,0,1,0,660,660
Gabrielle,0,1,0,81,81
Gael,1,0,14,0,14
Gaia,0,1,0,26,26
Gaius,1,0,35,0,35
Galadriel,0,1,0,10,10
Galina,0,1,0,505,505
Gamal,1,0,11,0,11
Gani,1,0,13,0,13
Ganimete,0,1,0,10,10
Garita,0,1,0,28,28
Gary,1,0,45,0,45
Gaston,1,0,17,0,17
Gavin,1,0,16,0,16
Gazmend,1,0,11,0,11
Gea,0,1,0,59,59
Geir,1,0,19,0,19
Gemma,0,1,0,19,19
Genevieve,0,1,0,11,11
Gennadi,1,0,32,0,32
Gennadjevna,0,1,0,10,10
Gennady,1,0,11,0,11
Gentiana,0,1,0,11,11
Geoffrey,1,0,24,0,24
Georg,1,0,1345,0,1345
George,1,0,355,0,355
Georges,1,0,53,0,53
Georgi,1,0,52,0,52
Georgia,0,1,0,26,26
Georgij,1,0,48,0,48
Georgina,0,1,0,54,54
Georgios,1,0,90,0,90
Georgy,1,0,18,0,18
Gerald,1,0,58,0,58
Geraldine,0,1,0,35,35
Gerard,1,0,30,0,30
Gérard,1,0,11,0,11
Gerd,0.0362116991643454,0.963788300835655,13,346,359
Gerda,0,1,0,235,235
Gerhard,1,0,266,0,266
Gerli,0,1,0,11,11
German,1,0,30,0,30
Germund,1,0,12,0,12
Geronimo,1,0,11,0,11
Gert,1,0,54,0,54
Gertrud,0,1,0,362,362
Gertrude,0,1,0,12,12
Ghassan,1,0,16,0,16
Ghazi,1,0,12,0,12
Gheorghe,1,0,10,0,10
Ghita,0,1,0,117,117
Gholam,1,0,20,0,20
Ghulam,1,0,14,0,14
Gia,0.333333333333333,0.666666666666667,34,68,102
Giacomo,1,0,10,0,10
Giada,0,1,0,12,12
Gian,1,0,11,0,11
Giang,0,1,0,13,13
Gianluca,1,0,10,0,10
Gianni,1,0,11,0,11
Gideon,1,0,171,0,171
Giia,0,1,0,10,10
Gil,1,0,10,0,10
Gilbert,1,0,104,0,104
Gilda,0,1,0,21,21
Gillian,0,1,0,13,13
Gillis,1,0,11,0,11
Gina,0,1,0,80,80
Gino,1,0,13,0,13
Giorgio,1,0,13,0,13
Giovanna,0,1,0,27,27
Giovanni,1,0,67,0,67
Gisela,0,1,0,153,153
Gisella,0,1,0,32,32
Giselle,0,1,0,26,26
Gita,0,1,0,48,48
Githa,0,1,0,18,18
Gitta,0,1,0,88,88
Gitte,0,1,0,79,79
Giulia,0,1,0,31,31
Giulio,1,0,17,0,17
Giuseppe,1,0,52,0,52
Gladys,0,1,0,42,42
Gleb,1,0,28,0,28
Glen,1,0,64,0,64
Glenn,1,0,251,0,251
Gloria,0,1,0,103,103
Glory,0,1,0,18,18
Gökhan,1,0,12,0,12
Gonzalo,1,0,13,0,13
Goran,1,0,22,0,22
Göran,1,0,3406,0,3406
Göransdotter,0,1,0,10,10
Göransson,1,0,19,0,19
Gordon,1,0,52,0,52
Görel,0,1,0,77,77
Gösta,1,0,732,0,732
Göta,0,1,0,430,430
Göte,1,0,84,0,84
Götha,0,1,0,11,11
Gottfrid,1,0,212,0,212
Gottfried,1,0,18,0,18
Gotthard,1,0,53,0,53
Gottlieb,1,0,16,0,16
Grace,0,1,0,242,242
Gracia,0,1,0,11,11
Graciela,0,1,0,11,11
Graham,1,0,23,0,23
Granit,1,0,12,0,12
Grant,1,0,18,0,18
Grazia,0,1,0,10,10
Graziella,0,1,0,11,11
Grazyna,0,1,0,16,16
Greeta,0,1,0,65,65
Greetta,0,1,0,129,129
Greger,1,0,249,0,249
Gregor,1,0,20,0,20
Gregori,1,0,10,0,10
Gregorio,1,0,15,0,15
Gregorius,1,0,35,0,35
Gregory,1,0,59,0,59
Grels,1,0,20,0,20
Gresa,0,1,0,19,19
Greta,0,1,0,1467,1467
Gretchen,0,1,0,13,13
Grete,0,1,0,22,22
Gretel,0,1,0,453,453
Grethel,0,1,0,13,13
Grigori,1,0,50,0,50
Grigorjevna,0,1,0,10,10
Grigory,1,0,15,0,15
Gry,0,1,0,10,10
Guadalupe,0,1,0,13,13
Gudmund,1,0,19,0,19
Gudrun,0,1,0,240,240
Guennadi,1,0,10,0,10
Guido,1,0,55,0,55
Guillaume,1,0,12,0,12
Guillermo,1,0,29,0,29
Gul,0,1,0,11,11
Gül,0,1,0,13,13
Guldine,0,1,0,11,11
Guled,1,0,25,0,25
Gullan,0,1,0,26,26
Gullborg,0,1,0,10,10
Gullbritt,0,1,0,11,11
Gull-Britt,0,1,0,24,24
Gullevi,0,1,0,26,26
Gull-Maj,0,1,0,20,20
Gullveig,0,1,0,12,12
Gullvi,0,1,0,21,21
Gun,0,1,0,942,942
Gunborg,0,1,0,325,325
Gunbritt,0,1,0,45,45
Gun-Britt,0,1,0,429,429
Gunda,0,1,0,97,97
Gundborg,0,1,0,12,12
Gundel,0,1,0,55,55
Gunder,1,0,48,0,48
Gungerd,0,1,0,11,11
Gunhard,1,0,15,0,15
Gunhild,0,1,0,502,502
Gunilla,0,1,0,2273,2273
Gunlis,0,1,0,53,53
Gun-Lis,0,1,0,116,116
Gunlög,0,1,0,77,77
Gun-Maj,0,1,0,139,139
Gun-Mari,0,1,0,23,23
Gun-Marie,0,1,0,39,39
Gun-May,0,1,0,39,39
Gunn,0,1,0,103,103
Gunnar,1,0,4525,0,4525
Gunnari,1,0,71,0,71
Gunnarson,1,0,11,0,11
Gunnarsson,1,0,34,0,34
Gunn-Britt,0,1,0,103,103
Gunne,0,1,0,14,14
Gunnel,0,1,0,1112,1112
Gunne-Maj,0,1,0,13,13
Gunnevi,0,1,0,254,254
Gunni,0,1,0,50,50
Gunni-Maj,0,1,0,12,12
Gunn-Lis,0,1,0,13,13
Gunn-Maj,0,1,0,17,17
Günter,1,0,18,0,18
Günther,1,0,21,0,21
Gunvald,1,0,22,0,22
Gunveig,0,1,0,43,43
Gunvi,0,1,0,32,32
Gun-Viol,0,1,0,37,37
Gunvor,0,1,0,1166,1166
Gurli,0,1,0,270,270
Gustaava,0,1,0,19,19
Gustaf,1,0,1752,0,1752
Gustav,1,0,4384,0,4384
Gustava,0,1,0,77,77
Gustav-Adolf,1,0,10,0,10
Gustavo,1,0,37,0,37
Gusten,1,0,10,0,10
Guy,1,0,629,0,629
Guy-Erik,1,0,14,0,14
Gwen,0,1,0,14,14
Ha,0,1,0,71,71
Haakon,1,0,74,0,74
Habib,0.830985915492958,0.169014084507042,59,12,71
Habiba,0,1,0,31,31
Haci,1,0,11,0,11
Haddy,0,1,0,11,11
Hadi,0.852941176470588,0.147058823529412,58,10,68
Hafidh,1,0,10,0,10
Hafsa,0,1,0,73,73
Hagar,0,1,0,104,104
Hagi,1,0,17,0,17
Hai,0.731707317073171,0.268292682926829,60,22,82
Haidar,1,0,62,0,62
Haider,1,0,22,0,22
Haidi,0,1,0,10,10
Hailey,0,1,0,23,23
Haitham,1,0,14,0,14
Hajar,0,1,0,23,23
Haji,0.6,0.4,18,12,30
Hakan,1,0,46,0,46
Håkan,1,0,1873,0,1873
Håkansdotter,0,1,0,14,14
Håkansson,1,0,13,0,13
Hakim,1,0,61,0,61
Hakon,1,0,51,0,51
Haley,0,1,0,11,11
Halil,1,0,33,0,33
Halim,1,0,11,0,11
Halima,0,1,0,65,65
Halimo,0,1,0,46,46
Halina,0,1,0,29,29
Halla,0,1,0,118,118
Halti,1,0,45,0,45
Halvar,1,0,13,0,13
Hamad,1,0,11,0,11
Hamda,0,1,0,13,13
Hamdi,0.228915662650602,0.771084337349398,19,64,83
Hamed,1,0,33,0,33
Hamid,0.844262295081967,0.155737704918033,103,19,122
Hamida,0,1,0,13,13
Hamilton,1,0,11,0,11
Hamish,1,0,13,0,13
Hampus,1,0,139,0,139
Hamsa,1,0,24,0,24
Hamse,1,0,19,0,19
Hamza,1,0,166,0,166
Hamzah,1,0,13,0,13
Hamze,1,0,12,0,12
Han,0.533333333333333,0.466666666666667,24,21,45
Hana,0,1,0,38,38
Hanaan,0,1,0,18,18
Hanad,1,0,29,0,29
Hanan,0,1,0,45,45
Hang,0,1,0,39,39
Hanh,0,1,0,36,36
Hani,0.229166666666667,0.770833333333333,22,74,96
Hanin,0,1,0,12,12
Hanna,0,1,0,24359,24359
Hanna-Elina,0,1,0,43,43
Hanna-Elisa,0,1,0,11,11
Hanna-Emilia,0,1,0,13,13
Hannah,0,1,0,377,377
Hanna-Helena,0,1,0,19,19
Hanna-Kaarina,0,1,0,26,26
Hanna-Kaija,0,1,0,14,14
Hannakaisa,0,1,0,89,89
Hanna-Kaisa,0,1,0,893,893
Hanna-Karoliina,0,1,0,15,15
Hanna-Katariina,0,1,0,19,19
Hanna-Katri,0,1,0,19,19
Hanna-Katriina,0,1,0,11,11
Hanna-Laura,0,1,0,10,10
Hanna-Lea,0,1,0,14,14
Hannaleena,0,1,0,168,168
Hanna-Leena,0,1,0,1294,1294
Hanna-Lena,0,1,0,18,18
Hannaliisa,0,1,0,40,40
Hanna-Liisa,0,1,0,294,294
Hanna-Lotta,0,1,0,18,18
Hanna-Maaria,0,1,0,64,64
Hanna-Maarit,0,1,0,63,63
Hannamaija,0,1,0,46,46
Hanna-Maija,0,1,0,393,393
Hannamari,0,1,0,446,446
Hanna-Mari,0,1,0,1268,1268
Hannamaria,0,1,0,54,54
Hanna-Maria,0,1,0,685,685
Hanna-Marie,0,1,0,10,10
Hanna-Marika,0,1,0,20,20
Hanna-Marja,0,1,0,41,41
Hanna-Pauliina,0,1,0,15,15
Hanna-Reeta,0,1,0,17,17
Hanna-Reetta,0,1,0,81,81
Hannariikka,0,1,0,28,28
Hanna-Riikka,0,1,0,291,291
Hannariina,0,1,0,15,15
Hanna-Riina,0,1,0,33,33
Hanna-Riitta,0,1,0,98,98
Hanna-Sisko,0,1,0,14,14
Hanna-Sofia,0,1,0,34,34
Hannastiina,0,1,0,13,13
Hanna-Stiina,0,1,0,11,11
Hanna-Tuulia,0,1,0,13,13
Hanne,0.0111272375423319,0.988872762457668,23,2044,2067
Hannele,0,1,0,86891,86891
Hanne-Leena,0,1,0,15,15
Hanneli,0,1,0,476,476
Hannelore,0,1,0,27,27
Hanne-Maaria,0,1,0,11,11
Hanne-Maarit,0,1,0,29,29
Hannemari,0,1,0,36,36
Hanne-Mari,0,1,0,143,143
Hanne-Maria,0,1,0,54,54
Hanne-Marie,0,1,0,13,13
Hanne-Riikka,0,1,0,10,10
Hannes,1,0,3524,0,3524
Hanni,0,1,0,279,279
Hannika,0,1,0,10,10
Hanni-Mari,0,1,0,10,10
Hanno,1,0,78,0,78
Hannu,1,0,35578,0,35578
Hannu-Heikki,1,0,20,0,20
Hannu-Matti,1,0,39,0,39
Hannunpoika,1,0,284,0,284
Hannuntytär,0,1,0,87,87
Hannu-Pekka,1,0,303,0,303
Hannu-Tapio,1,0,10,0,10
Hans,1,0,3835,0,3835
Hans-Christian,1,0,15,0,15
Hansdotter,0,1,0,13,13
Hans-Erik,1,0,152,0,152
Hans-Göran,1,0,21,0,21
Hans-Henrik,1,0,13,0,13
Hansi,1,0,14,0,14
Hans-Olof,1,0,28,0,28
Hans-Peter,1,0,43,0,43
Hany,1,0,16,0,16
Hao,1,0,33,0,33
Harald,1,0,1322,0,1322
Harding,1,0,17,0,17
Hardy,1,0,45,0,45
Hari,1,0,17,0,17
Haris,1,0,37,0,37
Harley,1,0,21,0,21
Harold,1,0,48,0,48
Haron,1,0,13,0,13
Haroun,1,0,11,0,11
Harras,1,0,89,0,89
Harri,1,0,22585,0,22585
Harriet,0,1,0,1646,1646
Harriette,0,1,0,21,21
Harrinpoika,1,0,173,0,173
Harrintytär,0,1,0,41,41
Harri-Pekka,1,0,70,0,70
Harris,1,0,11,0,11
Harrison,1,0,39,0,39
Harro,1,0,14,0,14
Harry,1,0,3445,0,3445
Harto,1,0,145,0,145
Hartti,1,0,40,0,40
Hartvig,1,0,10,0,10
Harun,1,0,31,0,31
Hasan,0.896039603960396,0.103960396039604,181,21,202
Hashem,1,0,13,0,13
Hashi,0.59375,0.40625,19,13,32
Hashim,0.793650793650794,0.206349206349206,50,13,63
Hassan,0.669914738124239,0.330085261875761,550,271,821
Hasse,1,0,110,0,110
Hassen,1,0,19,0,19
Hatem,1,0,20,0,20
Hatice,0,1,0,29,29
Hava,0,1,0,14,14
Havanna,0,1,0,12,12
Havin,0,1,0,15,15
Havina,0,1,0,10,10
Havu,1,0,50,0,50
Hawa,0,1,0,38,38
Hawo,0,1,0,36,36
Hayat,0,1,0,12,12
Haydar,1,0,16,0,16
Hayden,1,0,12,0,12
Hayder,1,0,12,0,12
Hayley,0,1,0,19,19
Hazal,0,1,0,10,10
Hazel,0,1,0,29,29
Heather,0,1,0,31,31
Heba,0,1,0,10,10
Hebe,0,1,0,16,16
Hector,1,0,54,0,54
Hedda,0,1,0,113,113
Heddy,0,1,0,14,14
Hedi,0.555555555555556,0.444444444444444,15,12,27
Hedvig,0,1,0,436,436
Hedwig,0,1,0,21,21
Hedy,0,1,0,13,13
Heelmä,0,1,0,11,11
Heide,0,1,0,10,10
Heidi,0,1,0,23903,23903
Heidi-Hannele,0,1,0,10,10
Heidi-Johanna,0,1,0,10,10
Heidi-Maaria,0,1,0,16,16
Heidi-Maarit,0,1,0,17,17
Heidi-Mari,0,1,0,21,21
Heidi-Maria,0,1,0,226,226
Heidi-Marie,0,1,0,10,10
Heidi-Marika,0,1,0,13,13
Heidi-Marja,0,1,0,12,12
Heidi-Susanna,0,1,0,13,13
Heidy,0,1,0,11,11
Heikinpoika,1,0,347,0,347
Heikintytär,0,1,0,98,98
Heikka,1,0,13,0,13
Heikki,1,0,54256,0,54256
Heikki-Juhani,1,0,22,0,22
Heikki-Jussi,1,0,10,0,10
Heikki-Matti,1,0,15,0,15
Heikki-Pekka,1,0,33,0,33
Heikki-Tapio,1,0,15,0,15
Heile,0,1,0,10,10
Heili,0,1,0,45,45
Heilimä,0,1,0,15,15
Heimer,1,0,69,0,69
Heimo,1,0,4193,0,4193
Heine,0,1,0,21,21
Heiner,1,0,14,0,14
Heini,0,1,0,3826,3826
Heinikki,0,1,0,57,57
Heini-Maaria,0,1,0,10,10
Heini-Maria,0,1,0,47,47
Heini-Marja,0,1,0,12,12
Heino,1,0,1661,0,1661
Heinrich,1,0,92,0,92
Heinz,1,0,55,0,55
Hektor,1,0,26,0,26
Heldine,0,1,0,50,50
Hele,0,1,0,84,84
Helea,0,1,0,27,27
Heleena,0,1,0,4373,4373
Helen,0,1,0,1343,1343
Helén,0,1,0,152,152
Helena,0,1,0,127508,127508
Heléna,0,1,0,15,15
Helene,0,1,0,1504,1504
Heléne,0,1,0,80,80
Hélène,0,1,0,62,62
Heleni,0,1,0,18,18
Helfrid,0,1,0,48,48
Helga,0,1,0,2121,2121
Helge,1,0,1860,0,1860
Heli,0,1,0,16736,16736
Helia,0,1,0,13,13
Heliä,0,1,0,31,31
Helianna,0,1,0,40,40
Heli-Johanna,0,1,0,11,11
Heli-Maaria,0,1,0,11,11
Heli-Maarit,0,1,0,25,25
Heli-Maija,0,1,0,23,23
Heli-Maria,0,1,0,37,37
Heli-Marja,0,1,0,28,28
Helin,0,1,0,71,71
Helina,0,1,0,29,29
Helinä,0,1,0,9695,9695
Heline,0,1,0,22,22
Heli-Riitta,0,1,0,14,14
Heli-Sisko,0,1,0,10,10
Helja,0,1,0,14,14
Heljä,0,1,0,1924,1924
Heljo,1,0,24,0,24
Helka,0,1,0,2563,2563
Helka-Maria,0,1,0,10,10
Helke,1,0,41,0,41
Helkky,0,1,0,88,88
Helky,0,1,0,39,39
Hella,0,1,0,20,20
Hellä,0,1,0,663,663
Helle,0,1,0,249,249
Helleka,0,1,0,12,12
Hellen,0,1,0,419,419
Helleni,0,1,0,20,20
Hellevi,0,1,0,11063,11063
Helli,0,1,0,2194,2194
Hellikki,0,1,0,295,295
Hellin,0,1,0,2134,2134
Helly,0,1,0,116,116
Helma,0,1,0,17,17
Helme,0,1,0,15,15
Helmer,1,0,1033,0,1033
Helmeri,1,0,465,0,465
Helmi,0,1,0,16912,16912
Helmi-Elisa,0,1,0,10,10
Helmiida,0,1,0,11,11
Helmi-Ilona,0,1,0,11,11
Helmiina,0,1,0,2603,2603
Helmililja,0,1,0,11,11
Helmi-Lilja,0,1,0,11,11
Helmi-Lotta,0,1,0,17,17
Helmi-Maria,0,1,0,67,67
Helmina,0,1,0,33,33
Helmi-Riitta,0,1,0,14,14
Helmi-Sofia,0,1,0,31,31
Helmut,1,0,49,0,49
Helmuth,1,0,17,0,17
Helny,0,1,0,35,35
Heloisa,0,1,0,121,121
Heloise,0,1,0,10,10
Helpi,0,1,0,56,56
Helve,0,1,0,11,11
Helvi,0,1,0,7073,7073
Hely,0,1,0,1363,1363
Hemi,1,0,20,0,20
Hemmi,1,0,280,0,280
Hemming,1,0,431,0,431
Hemminki,1,0,424,0,424
Hemmo,1,0,782,0,782
Hendrik,1,0,122,0,122
Hendrika,0,1,0,15,15
Hendry,1,0,32,0,32
Henja,0,1,0,10,10
Henje,0,1,0,11,11
Henkka,1,0,13,0,13
Henna,0,1,0,11350,11350
Henna-Emilia,0,1,0,14,14
Henna-Kaisa,0,1,0,43,43
Henna-Leena,0,1,0,45,45
Henna-Liisa,0,1,0,27,27
Henna-Maaria,0,1,0,33,33
Henna-Maarit,0,1,0,26,26
Henna-Maija,0,1,0,39,39
Hennamari,0,1,0,27,27
Henna-Mari,0,1,0,121,121
Henna-Maria,0,1,0,166,166
Henna-Reetta,0,1,0,15,15
Hennariikka,0,1,0,104,104
Henna-Riikka,0,1,0,551,551
Hennariina,0,1,0,18,18
Henna-Riina,0,1,0,30,30
Henna-Riitta,0,1,0,31,31
Henna-Sofia,0,1,0,14,14
Henni,0,1,0,1246,1246
Henniina,0,1,0,99,99
Hennika,0,1,0,18,18
Henning,1,0,201,0,201
Henno,1,0,30,0,30
Henny,0,1,0,117,117
Henri,1,0,15434,0,15434
Henric,1,0,67,0,67
Henrica,0,1,0,120,120
Henrick,1,0,13,0,13
Henrietta,0,1,0,1673,1673
Henriette,0,1,0,322,322
Henriika,0,1,0,397,397
Henriikka,0,1,0,5905,5905
Henriina,0,1,0,82,82
Henriitta,0,1,0,20,20
Henrik,1,0,35462,0,35462
Henrika,0,1,0,1230,1230
Henrikinpoika,1,0,18,0,18
Henrikka,0,1,0,14,14
Henrikki,1,0,6340,0,6340
Henriksdotter,0,1,0,47,47
Henriksson,1,0,11,0,11
Henri-Matias,1,0,10,0,10
Henri-Mikael,1,0,13,0,13
Henrinpoika,1,0,37,0,37
Henrintytär,0,1,0,13,13
Henri-Pekka,1,0,30,0,30
Henrique,1,0,13,0,13
Henrita,0,1,0,28,28
Henry,1,0,6694,0,6694
Henryk,1,0,23,0,23
Henrynpoika,1,0,13,0,13
Henteri,1,0,46,0,46
Hento,0,1,0,10,10
Hentriika,0,1,0,10,10
Hentriikka,0,1,0,13,13
Heppu,1,0,34,0,34
Herbert,1,0,621,0,621
Herdis,0,1,0,11,11
Heribert,1,0,29,0,29
Herkko,1,0,367,0,367
Herman,1,0,4650,0,4650
Hermann,1,0,147,0,147
Hermanni,1,0,7739,0,7739
Hermes,1,0,16,0,16
Hermiina,0,1,0,14,14
Hermine,0,1,0,28,28
Hero,0,1,0,11,11
Herpertti,1,0,11,0,11
Herrick,1,0,13,0,13
Herta,0,1,0,12,12
Hertta,0,1,0,1849,1849
Hesekiel,1,0,27,0,27
Hesham,1,0,12,0,12
Hessu,1,0,24,0,24
Heta,0,1,0,2017,2017
Heta-Liisa,0,1,0,17,17
Heta-Maija,0,1,0,15,15
Heta-Maria,0,1,0,18,18
Hetastiina,0,1,0,26,26
Heta-Stiina,0,1,0,10,10
Hetta,0,1,0,40,40
Hetti,0,1,0,70,70
Hiba,0,1,0,30,30
Hibaaq,0,1,0,11,11
Hibo,0,1,0,27,27
Hicham,1,0,20,0,20
Hien,0.382352941176471,0.617647058823529,13,21,34
Hiep,1,0,12,0,12
Hieu,1,0,31,0,31
Hila,0,1,0,13,13
Hilari,1,0,12,0,12
Hilarius,1,0,33,0,33
Hilda,0,1,0,2976,2976
Hilda-Maria,0,1,0,21,21
Hilde,0,1,0,87,87
Hildegard,0,1,0,326,326
Hildegund,0,1,0,10,10
Hildi,0,1,0,26,26
Hilding,1,0,505,0,505
Hildur,0,1,0,162,162
Hilja,0,1,0,4813,4813
Hilja-Maria,0,1,0,32,32
Hilkka,0,1,0,17602,17602
Hilkka-Leena,0,1,0,10,10
Hilkka-Liisa,0,1,0,161,161
Hilkka-Maija,0,1,0,38,38
Hilla,0,1,0,2669,2669
Hilla-Maaria,0,1,0,27,27
Hillamari,0,1,0,11,11
Hilla-Mari,0,1,0,13,13
Hillamaria,0,1,0,15,15
Hilla-Maria,0,1,0,56,56
Hilla-Marja,0,1,0,14,14
Hille,0.0871559633027523,0.912844036697248,19,199,218
Hillervo,0.0237529691211401,0.97624703087886,10,411,421
Hillevi,0,1,0,7274,7274
Hilli,0,1,0,11,11
Hilma,0,1,0,3349,3349
Hilmer,1,0,42,0,42
Hilmi,1,0,12,0,12
Hilpa,0,1,0,11,11
Hilpas,1,0,16,0,16
Hilpe,0,1,0,16,16
Hilpi,0.0829268292682927,0.917073170731707,17,188,205
Hilppa,0,1,0,371,371
Hilta,0,1,0,20,20
Hilve,0,1,0,123,123
Himmi,0,1,0,11,11
Hind,0,1,0,15,15
Hinda,0,1,0,11,11
Hinni,0,1,0,93,93
Hinriikka,0,1,0,10,10
Hintriikka,0,1,0,15,15
Hippu,0,1,0,35,35
Hisham,1,0,25,0,25
Hiski,1,0,197,0,197
Hiskias,1,0,76,0,76
Hiwa,1,0,13,0,13
Hjalmar,1,0,930,0,930
Hjalmari,1,0,32,0,32
Hjalte,1,0,15,0,15
Hjördis,0,1,0,365,365
Ho,1,0,15,0,15
Hoa,0.390625,0.609375,25,39,64
Hoai,1,0,12,0,12
Hoang,0.676691729323308,0.323308270676692,90,43,133
Hoda,0,1,0,22,22
Hodan,0,1,0,63,63
Holger,1,0,1022,0,1022
Holgersson,1,0,22,0,22
Holly,0,1,0,21,21
Hong,0.355029585798817,0.644970414201183,60,109,169
Hope,0,1,0,49,49
Horst,1,0,29,0,29
Hossain,1,0,27,0,27
Hossein,1,0,35,0,35
Howard,1,0,30,0,30
Htoo,0.441176470588235,0.558823529411765,15,19,34
Hua,0,1,0,25,25
Hubert,1,0,59,0,59
Hubertus,1,0,24,0,24
Huda,0,1,0,57,57
Hue,0,1,0,23,23
Hugh,1,0,14,0,14
Hugo,1,0,3374,0,3374
Hui,0,1,0,16,16
Huima,1,0,14,0,14
Hulda,0,1,0,497,497
Humberto,1,0,14,0,14
Hung,1,0,78,0,78
Hunter,1,0,18,0,18
Huong,0,1,0,75,75
Husam,1,0,13,0,13
Husein,1,0,27,0,27
Hüseyin,1,0,44,0,44
Hussain,1,0,66,0,66
Hussein,0.719409282700422,0.280590717299578,341,133,474
Huu,1,0,52,0,52
Huugo,1,0,282,0,282
Huuko,1,0,83,0,83
Huvi,1,0,11,0,11
Huy,1,0,54,0,54
Huyen,0,1,0,36,36
Huynh,0,1,0,16,16
Hymy,0,1,0,82,82
Ia,0,1,0,164,164
Ian,1,0,266,0,266
Iana,0,1,0,19,19
Ibn,1,0,12,0,12
Ibraahim,1,0,11,0,11
Ibrahim,0.802250803858521,0.197749196141479,499,123,622
Ibtisam,0,1,0,15,15
Ida,0,1,0,13529,13529
Ida-Amanda,0,1,0,14,14
Ida-Annika,0,1,0,11,11
Ida-Elina,0,1,0,13,13
Ida-Emilia,0,1,0,50,50
Ida-Eveliina,0,1,0,10,10
Ida-Julia,0,1,0,13,13
Ida-Kaisa,0,1,0,23,23
Idaliina,0,1,0,10,10
Ida-Liina,0,1,0,10,10
Ida-Liisa,0,1,0,19,19
Ida-Lina,0,1,0,11,11
Ida-Lotta,0,1,0,54,54
Ida-Maija,0,1,0,22,22
Ida-Mari,0,1,0,31,31
Idamaria,0,1,0,41,41
Ida-Maria,0,1,0,728,728
Ida-Marie,0,1,0,27,27
Ida-Sofia,0,1,0,184,184
Idil,0,1,0,28,28
Idiris,1,0,23,0,23
Idor,1,0,15,0,15
Idris,1,0,46,0,46
Idun,0,1,0,34,34
Ifeoma,0,1,0,24,24
Ifrah,0,1,0,41,41
Ignacio,1,0,20,0,20
Ignatius,1,0,17,0,17
Igor,1,0,370,0,370
Ihab,1,0,11,0,11
Ihana,0,1,0,22,22
Ihanelma,0,1,0,217,217
Ihsan,1,0,15,0,15
Iia,0,1,0,193,193
Iida,0,1,0,16278,16278
Iida-Elina,0,1,0,14,14
Iida-Emilia,0,1,0,40,40
Iida-Eveliina,0,1,0,12,12
Iida-Kaisa,0,1,0,14,14
Iidaliina,0,1,0,27,27
Iida-Liina,0,1,0,21,21
Iida-Liisa,0,1,0,38,38
Iida-Lotta,0,1,0,39,39
Iida-Maaria,0,1,0,13,13
Iida-Maija,0,1,0,39,39
Iidamari,0,1,0,13,13
Iida-Mari,0,1,0,34,34
Iidamaria,0,1,0,36,36
Iida-Maria,0,1,0,566,566
Iida-Sofia,0,1,0,130,130
Iija,0,1,0,26,26
Iikka,1,0,1257,0,1257
Iina,0,1,0,6057,6057
Iina-Emilia,0,1,0,20,20
Iina-Kaisa,0,1,0,11,11
Iina-Lotta,0,1,0,13,13
Iina-Maija,0,1,0,14,14
Iina-Mari,0,1,0,17,17
Iina-Maria,0,1,0,79,79
Iina-Riikka,0,1,0,10,10
Iina-Sofia,0,1,0,21,21
Iines,0,1,0,1247,1247
Iinu,0,1,0,27,27
Iipo,1,0,15,0,15
Iippo,1,0,33,0,33
Iira,0,1,0,175,175
Iiri,0,1,0,63,63
Iiris,0,1,0,6381,6381
Iiro,1,0,3722,0,3722
Iironpoika,1,0,10,0,10
Iiro-Pekka,1,0,13,0,13
Iisa,0,1,0,1353,1353
Iisai,1,0,19,0,19
Iisak,1,0,1012,0,1012
Iisakki,1,0,5623,0,5623
Iiska,1,0,12,0,12
Iisko,1,0,43,0,43
Iissa,0,1,0,11,11
Iita,0,1,0,993,993
Iitamari,0,1,0,11,11
Iita-Maria,0,1,0,13,13
Iitu,0,1,0,349,349
Iivana,1,0,11,0,11
Iivar,1,0,77,0,77
Iivari,1,0,4114,0,4114
Iivi,0,1,0,25,25
Iivo,1,0,561,0,561
Iiwari,1,0,10,0,10
Ija,0,1,0,23,23
Ike,1,0,10,0,10
Ikechukwu,1,0,12,0,12
Ikenna,1,0,17,0,17
Iker,1,0,10,0,10
Ikhlas,0,1,0,11,11
Iko,1,0,19,0,19
Ikraam,0,1,0,14,14
Ikraan,0,1,0,10,10
Ikram,0,1,0,20,20
Ikran,0,1,0,17,17
Ila,0.342105263157895,0.657894736842105,13,25,38
Ilai,1,0,11,0,11
Ilan,1,0,14,0,14
Ilana,0,1,0,134,134
Ilari,1,0,13425,0,13425
Ilaria,0,1,0,18,18
Ilarinpoika,1,0,14,0,14
Ildiko,0,1,0,12,12
Ildikó,0,1,0,11,11
Ile,1,0,10,0,10
Ileana,0,1,0,14,14
Ilhaan,0,1,0,15,15
Ilham,0,1,0,27,27
Ilhan,0.555555555555556,0.444444444444444,20,16,36
Ilia,1,0,37,0,37
Iliana,0,1,0,22,22
Ilias,1,0,88,0,88
Ilija,1,0,12,0,12
Ilir,1,0,13,0,13
Ilja,1,0,642,0,642
Iljas,1,0,10,0,10
Ilkanpoika,1,0,121,0,121
Ilkantytär,0,1,0,37,37
Ilkka,1,0,14762,0,14762
Ilkka-Kristian,1,0,20,0,20
Ilkka-Pekka,1,0,18,0,18
Illusia,0,1,0,272,272
Illuusia,0,1,0,30,30
Ilma,0,1,0,396,396
Ilmar,1,0,50,0,50
Ilmari,1,0,71452,0,71452
Ilmarinen,1,0,15,0,15
Ilmarinpoika,1,0,10,0,10
Ilmatar,0,1,0,204,204
Ilmi,0,1,0,965,965
Ilmo,1,0,1340,0,1340
Ilo,0.822335025380711,0.177664974619289,162,35,197
Iloisa,0,1,0,11,11
Ilona,0,1,0,20920,20920
Ilpo,1,0,4683,0,4683
Ilponpoika,1,0,15,0,15
Ilppo,1,0,102,0,102
Ilsa,0,1,0,10,10
Ilse,0,1,0,717,717
Ilse-Maj,0,1,0,19,19
Ilta,0,1,0,561,561
Ilves,1,0,20,0,20
Ilya,1,0,55,0,55
Ilyas,1,0,82,0,82
Ilyes,1,0,14,0,14
Imad,1,0,30,0,30
Iman,0.116788321167883,0.883211678832117,16,121,137
Imane,0,1,0,11,11
Imanuel,1,0,31,0,31
Imelda,0,1,0,10,10
Immanuel,1,0,612,0,612
Immi,0,1,0,56,56
Immikki,0,1,0,11,11
Immo,1,0,332,0,332
Immu,1,0,17,0,17
Impi,0,1,0,997,997
Imraan,1,0,12,0,12
Imran,1,0,45,0,45
Imre,1,0,27,0,27
Ina,0,1,0,779,779
Ina-Maria,0,1,0,17,17
Inari,0.0114364135407136,0.988563586459286,25,2161,2186
Inas,0,1,0,13,13
Ina-Sofia,0,1,0,10,10
Inca,0,1,0,34,34
India,0,1,0,36,36
Indiana,0,1,0,13,13
Indigo,0.523809523809524,0.476190476190476,11,10,21
Indira,0,1,0,44,44
Indrek,1,0,20,0,20
Ines,0,1,0,839,839
Inès,0,1,0,21,21
Inessa,0,1,0,50,50
Inez,0,1,0,130,130
Inga,0,1,0,2407,2407
Inga-Britt,0,1,0,200,200
Inga-Lena,0,1,0,12,12
Inga-Liisa,0,1,0,39,39
Ingalill,0,1,0,261,261
Inga-Lill,0,1,0,582,582
Ingalis,0,1,0,10,10
Inga-Lis,0,1,0,35,35
Inga-Lisa,0,1,0,21,21
Inga-Maarit,0,1,0,12,12
Inga-Maj,0,1,0,23,23
Inga-Maria,0,1,0,34,34
Ingbert,1,0,10,0,10
Ingbritt,0,1,0,11,11
Ing-Britt,0,1,0,33,33
Inge,0.193069306930693,0.806930693069307,39,163,202
Ingeborg,0,1,0,3705,3705
Ingebritt,0,1,0,16,16
Inge-Britt,0,1,0,45,45
Ingegärd,0,1,0,494,494
Ingegerd,0,1,0,1543,1543
Ingela,0,1,0,237,237
Ingemaj,0,1,0,27,27
Inge-Maj,0,1,0,145,145
Ingemar,1,0,481,0,481
Inge-May,0,1,0,36,36
Ingemo,0,1,0,75,75
Inger,0,1,0,1784,1784
Ing-Maj,0,1,0,16,16
Ingmar,1,0,1366,0,1366
Ing-Mari,0,1,0,28,28
Ing-Marie,0,1,0,18,18
Ingmarsson,1,0,11,0,11
Ingo,1,0,14,0,14
Ingolf,1,0,76,0,76
Ingrid,0,1,0,2321,2321
Ingrit,0,1,0,11,11
Ingvald,1,0,326,0,326
Ingvar,1,0,339,0,339
Ingvor,0,1,0,54,54
Inja,0,1,0,11,11
Inka,0,1,0,5779,5779
Inkaliina,0,1,0,11,11
Inka-Liina,0,1,0,10,10
Inka-Liisa,0,1,0,15,15
Inka-Maaria,0,1,0,14,14
Inka-Mari,0,1,0,20,20
Inka-Maria,0,1,0,69,69
Inkariina,0,1,0,11,11
Inka-Riina,0,1,0,23,23
Inka-Sofia,0,1,0,13,13
Inke,0,1,0,17,17
Inkeri,0,1,0,42986,42986
Inki,0,1,0,10,10
Inna,0,1,0,836,836
Inni,0,1,0,20,20
Into,1,0,669,0,669
Ioan,1,0,26,0,26
Ioana,0,1,0,19,19
Ioanna,0,1,0,16,16
Ioannis,1,0,46,0,46
Ion,1,0,16,0,16
Iona,0,1,0,31,31
Ioulia,0,1,0,34,34
Iouri,1,0,25,0,25
Ippa,0,1,0,12,12
Iqbal,1,0,16,0,16
Iqra,0,1,0,30,30
Ira,0,1,0,1444,1444
Iraida,0,1,0,34,34
Ira-Maria,0,1,0,25,25
Ireena,0,1,0,11,11
Ireene,0,1,0,680,680
Irem,0,1,0,18,18
Iren,0,1,0,28,28
Irén,0,1,0,29,29
Irena,0,1,0,126,126
Irene,0,1,0,23485,23485
Iréne,0,1,0,138,138
Irène,0,1,0,19,19
Irené,0,1,0,20,20
Irfan,1,0,25,0,25
Iri,0,1,0,20,20
Iria,0,1,0,15,15
Irina,0,1,0,3892,3892
Irini,0,1,0,25,25
Irinja,0,1,0,151,151
Iris,0,1,0,3068,3068
Irja,0,1,0,12714,12714
Irja-Leena,0,1,0,19,19
Irja-Liisa,0,1,0,104,104
Irkka,0,1,0,49,49
Irma,0,1,0,12875,12875
Irma-Leena,0,1,0,16,16
Irma-Liisa,0,1,0,72,72
Irmeli,0,1,0,29630,29630
Irmelin,0,1,0,104,104
Irmgard,0,1,0,21,21
Iro,0.28,0.72,14,36,50
Iryna,0,1,0,25,25
Isa,0.0232558139534884,0.976744186046512,21,882,903
Isaac,1,0,117,0,117
Isabel,0,1,0,1754,1754
Isabela,0,1,0,16,16
Isabell,0,1,0,254,254
Isabella,0,1,0,5115,5115
Isabelle,0,1,0,566,566
Isac,1,0,233,0,233
Isadora,0,1,0,130,130
Isaiah,1,0,19,0,19
Isak,1,0,1098,0,1098
Isa-Maria,0,1,0,23,23
Isatou,0,1,0,20,20
Isela,0,1,0,29,29
Iselin,0,1,0,19,19
Isella,0,1,0,26,26
Ishak,1,0,14,0,14
Isidor,1,0,98,0,98
Iska,1,0,24,0,24
Isko,1,0,66,0,66
Isla,0,1,0,1850,1850
Islam,1,0,22,0,22
Isma,1,0,10,0,10
Ismael,1,0,100,0,100
Ismahan,0,1,0,15,15
Ismail,0.809210526315789,0.190789473684211,246,58,304
Isman,1,0,10,0,10
Ismari,1,0,21,0,21
Ismet,1,0,29,0,29
Ismo,1,0,7079,0,7079
Ismonpoika,1,0,29,0,29
Ismontytär,0,1,0,10,10
Isobel,0,1,0,20,20
Isolde,0,1,0,34,34
Isra,0,1,0,52,52
Israa,0,1,0,14,14
Israel,1,0,126,0,126
Issa,1,0,16,0,16
Isse,0.589285714285714,0.410714285714286,33,23,56
Isto,1,0,980,0,980
Istvan,1,0,15,0,15
István,1,0,34,0,34
Ivan,1,0,427,0,427
Ivana,0,1,0,26,26
Ivanka,0,1,0,15,15
Ivanov,1,0,15,0,15
Ivanova,0,1,0,21,21
Ivanovna,0,1,0,35,35
Ivar,1,0,787,0,787
Ivo,1,0,43,0,43
Ivonne,0,1,0,11,11
Ivy,0,1,0,30,30
Iwona,0,1,0,10,10
Iza,0,1,0,16,16
Izabel,0,1,0,20,20
Izabela,0,1,0,16,16
Izabell,0,1,0,13,13
Izabella,0,1,0,70,70
Izabelle,0,1,0,28,28
J,1,0,11,0,11
Jaael,0,1,0,13,13
Jaafar,1,0,17,0,17
Jaajo,1,0,122,0,122
Jaakkima,1,0,158,0,158
Jaakko,1,0,39206,0,39206
Jaakko-Juhani,1,0,22,0,22
Jaakko-Matti,1,0,11,0,11
Jaakko-Pekka,1,0,31,0,31
Jaako,1,0,142,0,142
Jaakob,1,0,158,0,158
Jaakonpoika,1,0,173,0,173
Jaakontytär,0,1,0,44,44
Jaakoppi,1,0,232,0,232
Jaan,1,0,158,0,158
Jaana,0,1,0,23081,23081
Jaana-Kaisa,0,1,0,18,18
Jaana-Liisa,0,1,0,22,22
Jaana-Maarit,0,1,0,23,23
Jaana-Maija,0,1,0,20,20
Jaana-Mari,0,1,0,17,17
Jaana-Maria,0,1,0,34,34
Jaana-Marja,0,1,0,16,16
Jaani,1,0,308,0,308
Jaanika,0,1,0,41,41
Jaanus,1,0,21,0,21
Jaapo,1,0,11,0,11
Jaarli,1,0,20,0,20
Jabar,1,0,10,0,10
Jabbar,0.67741935483871,0.32258064516129,21,10,31
Jaber,0.575757575757576,0.424242424242424,19,14,33
Jace,1,0,11,0,11
Jacek,1,0,15,0,15
Jacinda,0,1,0,11,11
Jack,1,0,343,0,343
Jackson,1,0,26,0,26
Jacob,1,0,503,0,503
Jacoba,0,1,0,11,11
Jacobus,1,0,14,0,14
Jacqueline,0,1,0,84,84
Jacques,1,0,59,0,59
Jad,1,0,10,0,10
Jada,0,1,0,48,48
Jade,0,1,0,1944,1944
Jadele,0,1,0,10,10
Jadeliina,0,1,0,20,20
Jade-Maria,0,1,0,10,10
Jadessa,0,1,0,288,288
Jadette,0,1,0,10,10
Jadwiga,0,1,0,15,15
Jael,0.245283018867925,0.754716981132076,13,40,53
Jafar,1,0,20,0,20
Jafet,1,0,59,0,59
Jahangir,1,0,10,0,10
Jahn,1,0,19,0,19
Jahvetti,1,0,51,0,51
Jaime,1,0,41,0,41
Jake,1,0,261,0,261
Jaki,1,0,34,0,34
Jakim,1,0,12,0,12
Jakke,1,0,115,0,115
Jakob,1,0,860,0,860
Jakov,1,0,22,0,22
Jakub,1,0,20,0,20
Jalal,1,0,21,0,21
Jali,1,0,242,0,242
Jalle,1,0,22,0,22
Jallu,1,0,14,0,14
Jalmar,1,0,394,0,394
Jalmari,1,0,12499,0,12499
Jalmiina,0,1,0,25,25
Jalna,0,1,0,10,10
Jalo,1,0,1442,0,1442
Jama,0.619354838709677,0.380645161290323,96,59,155
Jamal,0.818181818181818,0.181818181818182,117,26,143
Jamelia,0,1,0,18,18
James,1,0,966,0,966
Jami,1,0,3162,0,3162
Jamie,0.821782178217822,0.178217821782178,83,18,101
Jamiel,1,0,106,0,106
Jamil,1,0,43,0,43
Jamila,0,1,0,68,68
Jamilla,0,1,0,23,23
Jamina,0,1,0,92,92
Jami-Petteri,1,0,24,0,24
Jan,1,0,9452,0,9452
Jana,0,1,0,185,185
Jan-Åke,1,0,29,0,29
Jan-Anders,1,0,152,0,152
Jan-Christer,1,0,24,0,24
Jan-Christian,1,0,62,0,62
Jane,0,1,0,608,608
Jan-Eerik,1,0,41,0,41
Janek,1,0,50,0,50
Janella,0,1,0,53,53
Janelle,0,1,0,21,21
Jan-Emil,1,0,18,0,18
Jan-Eric,1,0,88,0,88
Jan-Erik,1,0,1443,0,1443
Janessa,0,1,0,129,129
Janet,0,1,0,277,277
Janeta,0,1,0,14,14
Janeth,0,1,0,10,10
Janett,0,1,0,12,12
Janetta,0,1,0,96,96
Janette,0,1,0,2787,2787
Jan-Fredrik,1,0,12,0,12
Jan-Gustav,1,0,34,0,34
Jan-Håkan,1,0,22,0,22
Jan-Henrik,1,0,145,0,145
Jan-Henry,1,0,11,0,11
Jani,1,0,24214,0,24214
Janica,0,1,0,1192,1192
Janice,0,1,0,43,43
Janiel,1,0,78,0,78
Janiela,0,1,0,14,14
Janiika,0,1,0,47,47
Janiina,0,1,0,147,147
Jani-Juhani,1,0,15,0,15
Jani-Jukka,1,0,11,0,11
Janika,0,1,0,3023,3023
Jani-Kristian,1,0,12,0,12
Jani-Markus,1,0,28,0,28
Jani-Matti,1,0,92,0,92
Jani-Mikael,1,0,15,0,15
Janina,0,1,0,4064,4064
Janine,0,1,0,103,103
Janinpoika,1,0,90,0,90
Janintytär,0,1,0,25,25
Jani-Pekka,1,0,160,0,160
Jani-Petri,1,0,44,0,44
Jani-Petteri,1,0,205,0,205
Janira,0,1,0,10,10
Janis,1,0,12,0,12
Janissa,0,1,0,19,19
Janita,0,1,0,2590,2590
Janitta,0,1,0,30,30
Janka,0,1,0,14,14
Janko,1,0,14,0,14
Jan-Krister,1,0,25,0,25
Jan-Kristian,1,0,101,0,101
Jan-Magnus,1,0,21,0,21
Jan-Markus,1,0,78,0,78
Jan-Martin,1,0,12,0,12
Jan-Michael,1,0,25,0,25
Jan-Mikael,1,0,201,0,201
Jann,1,0,14,0,14
Janna,0,1,0,1594,1594
Janna-Mari,0,1,0,28,28
Janna-Maria,0,1,0,20,20
Janne,1,0,30098,0,30098
Janne-Juhani,1,0,24,0,24
Janne-Markus,1,0,12,0,12
Janne-Matti,1,0,60,0,60
Jannenpoika,1,0,201,0,201
Jannentytär,0,1,0,40,40
Janne-Pekka,1,0,140,0,140
Janne-Petteri,1,0,70,0,70
Janne-Veikko,1,0,10,0,10
Janni,0,1,0,753,753
Jannica,0,1,0,281,281
Jannice,0,1,0,10,10
Janniina,0,1,0,291,291
Jannik,1,0,13,0,13
Jannika,0,1,0,579,579
Jannike,0,1,0,66,66
Jannina,0,1,0,150,150
Jannis,1,0,31,0,31
Jannu,1,0,11,0,11
Jan-Ola,1,0,19,0,19
Jan-Olav,1,0,20,0,20
Jan-Ole,1,0,85,0,85
Jan-Olof,1,0,184,0,184
Janos,1,0,41,0,41
János,1,0,21,0,21
Jan-Ove,1,0,41,0,41
Jan-Patrik,1,0,18,0,18
Jan-Peter,1,0,210,0,210
Janrik,1,0,36,0,36
Jan-Robert,1,0,16,0,16
Jan-Roger,1,0,11,0,11
Jansdotter,0,1,0,28,28
Jan-Sebastian,1,0,19,0,19
Jan-Stefan,1,0,11,0,11
Janus,1,0,42,0,42
Janusz,1,0,10,0,10
Jaqueline,0,1,0,16,16
Jare,1,0,450,0,450
Jared,1,0,34,0,34
Jarek,1,0,12,0,12
Jari,1,0,41125,0,41125
Jari-Antti,1,0,15,0,15
Jari-Heikki,1,0,18,0,18
Jari-Juha,1,0,12,0,12
Jari-Juhani,1,0,33,0,33
Jari-Jukka,1,0,59,0,59
Jari-Jussi,1,0,13,0,13
Jari-Markus,1,0,15,0,15
Jarimatti,1,0,11,0,11
Jari-Matti,1,0,302,0,302
Jari-Mikko,1,0,12,0,12
Jarinpoika,1,0,338,0,338
Jarintytär,0,1,0,89,89
Jaripekka,1,0,17,0,17
Jari-Pekka,1,0,1332,0,1332
Jari-Petri,1,0,44,0,44
Jari-Petteri,1,0,58,0,58
Jarita,0,1,0,34,34
Jari-Tapio,1,0,14,0,14
Jari-Veikko,1,0,11,0,11
Jarkka,1,0,10,0,10
Jarkko,1,0,12641,0,12641
Jarkko-Juhani,1,0,11,0,11
Jarkko-Pekka,1,0,16,0,16
Jarko,1,0,218,0,218
Jarkonpoika,1,0,72,0,72
Jarkontytär,0,1,0,23,23
Jarl,1,0,1299,0,1299
Jarl-Erik,1,0,36,0,36
Jarl-Olof,1,0,13,0,13
Jarlsdotter,0,1,0,14,14
Jarmila,0,1,0,14,14
Jarmo,1,0,20982,0,20982
Jarmonpoika,1,0,94,0,94
Jarmontytär,0,1,0,25,25
Jarna,0,1,0,376,376
Jarno,1,0,7950,0,7950
Jarnonpoika,1,0,44,0,44
Jarnontytär,0,1,0,18,18
Jaro,1,0,426,0,426
Jaromir,1,0,41,0,41
Jaron,1,0,51,0,51
Jaroslav,1,0,37,0,37
Jaroslaw,1,0,11,0,11
Jarre,1,0,29,0,29
Jarto,1,0,27,0,27
Jasemin,0,1,0,12,12
Jasim,1,0,16,0,16
Jasin,1,0,48,0,48
Jasir,1,0,13,0,13
Jaska,1,0,249,0,249
Jasmi,0,1,0,187,187
Jasmiin,0,1,0,28,28
Jasmiina,0,1,0,1461,1461
Jasmiini,0,1,0,107,107
Jasmin,0.00165499681731381,0.998345003182686,13,7842,7855
Jasmina,0,1,0,684,684
Jasmine,0,1,0,1504,1504
Jasmo,1,0,12,0,12
Jasna,0,1,0,38,38
Jaso,1,0,39,0,39
Jason,1,0,324,0,324
Jaspar,1,0,12,0,12
Jasper,1,0,2509,0,2509
Jasperi,1,0,236,0,236
Jasse,1,0,235,0,235
Jasu,1,0,495,0,495
Jatta,0,1,0,849,849
Jauri,1,0,24,0,24
Javier,1,0,73,0,73
Jawad,1,0,17,0,17
Jay,1,0,69,0,69
Jayden,1,0,51,0,51
Jayne,0,1,0,13,13
Jayson,1,0,16,0,16
Jazmin,0,1,0,11,11
Jean,0.848739495798319,0.151260504201681,505,90,595
Jeanette,0,1,0,699,699
Jeanine,0,1,0,17,17
Jeanna,0,1,0,16,16
Jeanne,0,1,0,70,70
Jeannette,0,1,0,98,98
Jean-Paul,1,0,14,0,14
Jedi,1,0,47,0,47
Jeeli,1,0,38,0,38
Jeemi,1,0,19,0,19
Jeena,0,1,0,31,31
Jeff,1,0,24,0,24
Jeffrey,1,0,48,0,48
Jegor,1,0,29,0,29
Jehki,1,0,17,0,17
Jekateriina,0,1,0,21,21
Jekaterina,0,1,0,163,163
Jekku,1,0,12,0,12
Jelena,0,1,0,565,565
Jelina,0,1,0,33,33
Jelizaveta,0,1,0,10,10
Jella,0,1,0,25,25
Jelmeri,1,0,32,0,32
Jemi,1,0,49,0,49
Jemiina,0,1,0,129,129
Jemil,1,0,10,0,10
Jemila,0,1,0,10,10
Jemilia,0,1,0,25,25
Jemima,0,1,0,82,82
Jemina,0,1,0,3091,3091
Jeminna,0,1,0,11,11
Jena,0,1,0,15,15
Jeni,0,1,0,44,44
Jenica,0,1,0,62,62
Jenifer,0,1,0,35,35
Jeniina,0,1,0,12,12
Jenika,0,1,0,73,73
Jenilla,0,1,0,13,13
Jenina,0,1,0,320,320
Jenissa,0,1,0,10,10
Jenita,0,1,0,172,172
Jenna,0,1,0,11497,11497
Jenna-Emilia,0,1,0,10,10
Jenna-Julia,0,1,0,46,46
Jenna-Juulia,0,1,0,17,17
Jenna-Maaria,0,1,0,12,12
Jennamari,0,1,0,10,10
Jenna-Mari,0,1,0,61,61
Jenna-Maria,0,1,0,86,86
Jennamiia,0,1,0,14,14
Jenna-Riikka,0,1,0,28,28
Jenna-Riina,0,1,0,17,17
Jenna-Sofia,0,1,0,14,14
Jenni,0,1,0,18012,18012
Jennica,0,1,0,159,159
Jennie,0,1,0,282,282
Jenni-Elina,0,1,0,13,13
Jenni-Emilia,0,1,0,21,21
Jennifer,0,1,0,845,845
Jenniina,0,1,0,591,591
Jenni-Johanna,0,1,0,30,30
Jenni-Julia,0,1,0,19,19
Jennika,0,1,0,361,361
Jenni-Kaisa,0,1,0,22,22
Jenni-Leena,0,1,0,16,16
Jenni-Liisa,0,1,0,12,12
Jenni-Maaria,0,1,0,11,11
Jenni-Maija,0,1,0,12,12
Jennimari,0,1,0,24,24
Jenni-Mari,0,1,0,73,73
Jenni-Maria,0,1,0,148,148
Jennina,0,1,0,145,145
Jenni-Sofia,0,1,0,19,19
Jenny,0,1,0,5995,5995
Jennyfer,0,1,0,18,18
Jenny-Maria,0,1,0,47,47
Jenny-Sofia,0,1,0,15,15
Jens,1,0,1092,0,1092
Jens-Erik,1,0,16,0,16
Jeppe,1,0,62,0,62
Jere,1,0,10557,0,10557
Jere-Juhani,1,0,12,0,12
Jere-Matias,1,0,19,0,19
Jere-Matti,1,0,21,0,21
Jeremi,1,0,148,0,148
Jeremia,1,0,604,0,604
Jeremiah,1,0,59,0,59
Jeremias,1,0,3402,0,3402
Jeremie,1,0,11,0,11
Jeremy,1,0,202,0,202
Jerenpoika,1,0,11,0,11
Jere-Pekka,1,0,24,0,24
Jere-Petteri,1,0,37,0,37
Jeri,1,0,123,0,123
Jerica,0,1,0,12,12
Jericho,1,0,11,0,11
Jerico,1,0,11,0,11
Jerika,0,1,0,29,29
Jeriko,1,0,20,0,20
Jerina,0,1,0,25,25
Jerita,0,1,0,14,14
Jerker,1,0,171,0,171
Jerkka,1,0,10,0,10
Jerkko,1,0,45,0,45
Jerko,1,0,23,0,23
Jermo,1,0,15,0,15
Jermu,1,0,253,0,253
Jero,1,0,156,0,156
Jerome,1,0,108,0,108
Jerri,1,0,91,0,91
Jerry,1,0,1487,0,1487
Jertta,0,1,0,34,34
Jerzy,1,0,23,0,23
Jesaja,1,0,15,0,15
Jesmiina,0,1,0,12,12
Jesmina,0,1,0,15,15
Jesper,1,0,2190,0,2190
Jesperi,1,0,594,0,594
Jesse,1,0,12114,0,12114
Jesse-Joonas,1,0,15,0,15
Jesse-Juhani,1,0,13,0,13
Jesse-Matias,1,0,11,0,11
Jesse-Pekka,1,0,17,0,17
Jesse-Petteri,1,0,19,0,19
Jessi,0,1,0,295,295
Jessica,0,1,0,4856,4856
Jessie,0,1,0,30,30
Jessiina,0,1,0,57,57
Jessika,0,1,0,833,833
Jessina,0,1,0,66,66
Jesus,1,0,19,0,19
Jethro,1,0,27,0,27
Jeton,1,0,13,0,13
Jetro,1,0,308,0,308
Jetta,0,1,0,110,110
Jette,0,1,0,12,12
Jevgeni,1,0,61,0,61
Jevgenia,0,1,0,26,26
Jhonny,1,0,14,0,14
Jia,0.352941176470588,0.647058823529412,12,22,34
Jian,1,0,15,0,15
Jibril,1,0,17,0,17
Jico,1,0,12,0,12
Jie,1,0,14,0,14
Jiia,0,1,0,18,18
Jiina,0,1,0,31,31
Jiko,1,0,26,0,26
Jill,0,1,0,84,84
Jilla,0,1,0,15,15
Jillian,0,1,0,12,12
Jim,1,0,684,0,684
Jimena,0,1,0,16,16
Jimi,1,0,4612,0,4612
Jimmi,1,0,18,0,18
Jimmie,1,0,32,0,32
Jimmy,1,0,824,0,824
Jimy,1,0,11,0,11
Jin,0.333333333333333,0.666666666666667,11,22,33
Jina,0,1,0,20,20
Jing,0,1,0,30,30
Jinka,0,1,0,16,16
Jinna,0,1,0,44,44
Jino,1,0,13,0,13
Jippu,0,1,0,12,12
Jiri,1,0,1212,0,1212
Jirka,1,0,160,0,160
Jirko,1,0,78,0,78
Jiro,1,0,127,0,127
Jiska,1,0,23,0,23
Jitta,0,1,0,14,14
Jo,0,1,0,17,17
Joa,0.964769647696477,0.035230352303523,356,13,369
Joachim,1,0,617,0,617
Joacim,1,0,137,0,137
Joackim,1,0,20,0,20
Joah,1,0,13,0,13
Joakim,1,0,4475,0,4475
Joan,0.18018018018018,0.81981981981982,20,91,111
Joana,0,1,0,48,48
Joanna,0,1,0,3071,3071
Joanne,0,1,0,72,72
Joannis,1,0,16,0,16
Joao,1,0,17,0,17
João,1,0,18,0,18
Joaquim,1,0,16,0,16
Joaquin,1,0,12,0,12
Joar,1,0,65,0,65
Joas,1,0,35,0,35
Jobi,1,0,15,0,15
Jocelyn,0,1,0,15,15
Jochen,1,0,24,0,24
Jochum,1,0,12,0,12
Jocke,1,0,16,0,16
Jockum,1,0,32,0,32
Joe,1,0,245,0,245
Joel,1,0,9584,0,9584
Joël,1,0,21,0,21
Joela,0,1,0,17,17
Joeli,1,0,130,0,130
Joeliina,0,1,0,10,10
Joella,0,1,0,19,19
Joenna,0,1,0,11,11
Jofiel,1,0,19,0,19
Johan,1,0,16650,0,16650
Johan-Erik,1,0,19,0,19
Johann,1,0,194,0,194
Johanna,0,1,0,112691,112691
Johanna-Maria,0,1,0,15,15
Johanne,0,1,0,48,48
Johannes,1,0,137482,0,137482
Johanni,1,0,11,0,11
Johansdotter,0,1,0,37,37
John,1,0,3624,0,3624
John-Eric,1,0,12,0,12
John-Erik,1,0,68,0,68
Johnny,1,0,835,0,835
Johny,1,0,40,0,40
Jokke,1,0,89,0,89
Jolana,0,1,0,15,15
Jolanda,0,1,0,275,275
Jolanta,0,1,0,16,16
Jolene,0,1,0,11,11
Jolie,0,1,0,21,21
Jolin,0,1,0,11,11
Jolina,0,1,0,16,16
Joline,0,1,0,18,18
Jomi,1,0,60,0,60
Jommi,1,0,27,0,27
Jon,1,0,828,0,828
Jona,0.875,0.125,70,10,80
Jonah,1,0,87,0,87
Jonas,1,0,2689,0,2689
Jonasdotter,0,1,0,18,18
Jonatan,1,0,1543,0,1543
Jonathan,1,0,2303,0,2303
Jonathon,1,0,10,0,10
Jone,1,0,240,0,240
Jon-Erik,1,0,14,0,14
Jones,1,0,25,0,25
Joni,1,0,15315,0,15315
Joni-Juhani,1,0,16,0,16
Joni-Kristian,1,0,12,0,12
Joni-Markus,1,0,26,0,26
Joni-Matti,1,0,45,0,45
Joni-Mikael,1,0,16,0,16
Jonina,0,1,0,28,28
Joninpoika,1,0,22,0,22
Joni-Pekka,1,0,89,0,89
Joni-Petri,1,0,21,0,21
Joni-Petteri,1,0,98,0,98
Jonna,0,1,0,9208,9208
Jonna-Julia,0,1,0,14,14
Jonna-Kaisa,0,1,0,11,11
Jonna-Mari,0,1,0,47,47
Jonna-Maria,0,1,0,67,67
Jonna-Marika,0,1,0,10,10
Jonna-Riikka,0,1,0,29,29
Jonne,1,0,3646,0,3646
Jonnenpoika,1,0,11,0,11
Jonne-Pekka,1,0,11,0,11
Jonni,1,0,654,0,654
Jonnie,1,0,24,0,24
Jonny,1,0,417,0,417
Jonte,1,0,17,0,17
Jontte,1,0,12,0,12
Jonttu,1,0,14,0,14
Jony,1,0,68,0,68
Jooa,1,0,1190,0,1190
Jooas,1,0,19,0,19
Jooel,1,0,120,0,120
Joona,1,0,11578,0,11578
Joonaksenpoika,1,0,14,0,14
Joona-Matias,1,0,12,0,12
Joona-Pekka,1,0,13,0,13
Joona-Petteri,1,0,18,0,18
Joonas,1,0,18017,0,18017
Joonas-Petteri,1,0,29,0,29
Joonatan,1,0,7182,0,7182
Joonathan,1,0,29,0,29
Joonia,1,0,30,0,30
Joonis,1,0,10,0,10
Joopi,1,0,12,0,12
Joosa,1,0,40,0,40
Joose,1,0,837,0,837
Joosef,1,0,106,0,106
Joosefiina,0,1,0,15,15
Jooseppi,1,0,962,0,962
Joosia,1,0,21,0,21
Joosu,1,0,42,0,42
Joosua,1,0,482,0,482
Jopi,1,0,47,0,47
Joppe,1,0,13,0,13
Jöran,1,0,17,0,17
Jordan,0.88659793814433,0.11340206185567,86,11,97
Jore,1,0,50,0,50
Jörg,1,0,24,0,24
Jorge,1,0,53,0,53
Jörgen,1,0,673,0,673
Jorgos,1,0,11,0,11
Jori,1,0,1619,0,1619
Jori-Matti,1,0,11,0,11
Jori-Pekka,1,0,29,0,29
Jori-Petteri,1,0,10,0,10
Jorma,1,0,25047,0,25047
Jormanpoika,1,0,69,0,69
Jormantytär,0,1,0,15,15
Jörn,1,0,47,0,47
Josa,1,0,24,0,24
Jose,1,0,869,0,869
José,1,0,142,0,142
Josef,1,0,406,0,406
Josefa,0,1,0,14,14
Josefia,0,1,0,39,39
Josefiia,0,1,0,18,18
Josefiina,0,1,0,7612,7612
Josefin,0,1,0,715,715
Josefina,0,1,0,3167,3167
Josefine,0,1,0,662,662
Josep,1,0,10,0,10
Joseph,0.950859950859951,0.0491400491400491,387,20,407
Josephina,0,1,0,23,23
Josephine,0,1,0,309,309
Joséphine,0,1,0,26,26
Josetta,0,1,0,33,33
Josette,0,1,0,27,27
Joshua,1,0,352,0,352
Josi,1,0,65,0,65
Josia,1,0,39,0,39
Josiah,1,0,17,0,17
Josias,1,0,17,0,17
Josie,0,1,0,13,13
Joska,1,0,103,0,103
Josse,1,0,17,0,17
Josu,1,0,14,0,14
Josua,1,0,144,0,144
Jotaarkka,1,0,11,0,11
Jouka,1,0,115,0,115
Jouki,0,1,0,12,12
Jouko,1,0,19176,0,19176
Joukonpoika,1,0,66,0,66
Joukontytär,0,1,0,11,11
Jouna,1,0,41,0,41
Jouni,1,0,19485,0,19485
Jouni-Matti,1,0,13,0,13
Jouninpoika,1,0,128,0,128
Jounintytär,0,1,0,34,34
Jouni-Pekka,1,0,33,0,33
Jousia,1,0,147,0,147
Joutsi,1,0,24,0,24
Joy,0,1,0,143,143
Joyce,0,1,0,48,48
József,1,0,10,0,10
Jr,1,0,21,0,21
Juan,0.916230366492147,0.0837696335078534,175,16,191
Juana,0,1,0,13,13
Juanita,0,1,0,64,64
Jude,1,0,17,0,17
Judit,0,1,0,229,229
Judith,0,1,0,259,259
Judy,0,1,0,20,20
Juha,1,0,54957,0,54957
Juha-Antti,1,0,52,0,52
Juha-Erkki,1,0,16,0,16
Juha-Heikki,1,0,44,0,44
Juha-Jaakko,1,0,20,0,20
Juha-Markku,1,0,12,0,12
Juha-Markus,1,0,32,0,32
Juha-Martti,1,0,11,0,11
Juhamatti,1,0,142,0,142
Juha-Matti,1,0,2359,0,2359
Juha-Mikael,1,0,14,0,14
Juha-Mikko,1,0,38,0,38
Juhan,1,0,161,0,161
Juhana,1,0,8762,0,8762
Juhananpoika,1,0,25,0,25
Juhanantytär,0,1,0,13,13
Juhani,1,0,291400,0,291400
Juhaninpoika,1,0,93,0,93
Juhanintytär,0,1,0,17,17
Juhannes,1,0,15,0,15
Juhanni,1,0,48,0,48
Juhanpoika,1,0,533,0,533
Juhantytär,0,1,0,129,129
Juhapekka,1,0,74,0,74
Juha-Pekka,1,0,3386,0,3386
Juha-Pertti,1,0,13,0,13
Juha-Petri,1,0,136,0,136
Juha-Petteri,1,0,151,0,151
Juha-Tapani,1,0,15,0,15
Juha-Tapio,1,0,28,0,28
Juha-Tuomas,1,0,12,0,12
Juha-Veikko,1,0,29,0,29
Juha-Veli,1,0,15,0,15
Juha-Ville,1,0,31,0,31
Juho,1,0,26547,0,26547
Juho-Aleksi,1,0,12,0,12
Juho-Antti,1,0,77,0,77
Juho-Eemil,1,0,13,0,13
Juho-Erik,1,0,13,0,13
Juho-Heikki,1,0,34,0,34
Juho-Jaakko,1,0,26,0,26
Juho-Joonas,1,0,10,0,10
Juho-Kalle,1,0,16,0,16
Juho-Kustaa,1,0,10,0,10
Juho-Kusti,1,0,20,0,20
Juho-Matias,1,0,38,0,38
Juhomatti,1,0,14,0,14
Juho-Matti,1,0,164,0,164
Juho-Mikko,1,0,18,0,18
Juhonpoika,1,0,74,0,74
Juhontytär,0,1,0,19,19
Juho-Oskari,1,0,21,0,21
Juhopekka,1,0,27,0,27
Juho-Pekka,1,0,288,0,288
Juho-Petteri,1,0,82,0,82
Juho-Tuomas,1,0,19,0,19
Juho-Veikko,1,0,12,0,12
Juho-Ville,1,0,33,0,33
Jukanpoika,1,0,358,0,358
Jukantytär,0,1,0,81,81
Jukka,1,0,41259,0,41259
Jukka-Antero,1,0,10,0,10
Jukka-Matti,1,0,73,0,73
Jukkapekka,1,0,46,0,46
Jukka-Pekka,1,0,3096,0,3096
Jukka-Petri,1,0,21,0,21
Jukka-Petteri,1,0,73,0,73
Jukka-Tapani,1,0,14,0,14
Jukka-Tapio,1,0,28,0,28
Juko,1,0,23,0,23
Julanda,0,1,0,17,17
Jules,1,0,37,0,37
Juli,0,1,0,59,59
Julia,0,1,0,20852,20852
Júlia,0,1,0,18,18
Juliaana,0,1,0,851,851
Julian,1,0,542,0,542
Juliana,0,1,0,823,823
Juliane,0,1,0,17,17
Julianna,0,1,0,798,798
Julianne,0,1,0,84,84
Julie,0,1,0,231,231
Julien,1,0,42,0,42
Julienna,0,1,0,12,12
Julienne,0,1,0,12,12
Juliet,0,1,0,208,208
Julieta,0,1,0,10,10
Julietta,0,1,0,84,84
Juliette,0,1,0,186,186
Julija,0,1,0,41,41
Julina,0,1,0,89,89
Julio,1,0,40,0,40
Juliska,0,1,0,13,13
Julita,0,1,0,15,15
Julitta,0,1,0,13,13
Julius,1,0,9396,0,9396
Julle,1,0,75,0,75
Jun,0.630434782608696,0.369565217391304,29,17,46
June,0,1,0,67,67
Juni,0,1,0,105,105
Junia,0,1,0,45,45
Junior,1,0,240,0,240
Juniori,1,0,15,0,15
Junita,0,1,0,11,11
Junno,1,0,18,0,18
Junnu,1,0,83,0,83
Juno,0.723076923076923,0.276923076923077,47,18,65
Jupiter,1,0,49,0,49
Jura,1,0,65,0,65
Jürgen,1,0,71,0,71
Juri,1,0,536,0,536
Jüri,1,0,32,0,32
Jurij,1,0,22,0,22
Jurjevna,0,1,0,28,28
Jurkka,1,0,39,0,39
Jurva,1,0,13,0,13
Jusa,1,0,188,0,188
Jusef,1,0,14,0,14
Juska,1,0,125,0,125
Jussa,1,0,100,0,100
Jusse,1,0,11,0,11
Jussi,1,0,22620,0,22620
Jussi-Heikki,1,0,12,0,12
Jussi-Joonas,1,0,11,0,11
Jussi-Matti,1,0,70,0,70
Jussi-Mikko,1,0,12,0,12
Jussinpoika,1,0,237,0,237
Jussintytär,0,1,0,51,51
Jussipekka,1,0,31,0,31
Jussi-Pekka,1,0,787,0,787
Jussi-Petteri,1,0,118,0,118
Jussi-Tapio,1,0,10,0,10
Jussi-Tuomas,1,0,10,0,10
Jussi-Ville,1,0,10,0,10
Justiina,0,1,0,1235,1235
Justin,1,0,100,0,100
Justina,0,1,0,83,83
Justine,0,1,0,18,18
Justus,1,0,1907,0,1907
Justyna,0,1,0,10,10
Jusu,1,0,44,0,44
Jusuf,1,0,16,0,16
Jutta,0,1,0,2811,2811
Jutta-Mari,0,1,0,10,10
Jutta-Maria,0,1,0,15,15
Juudit,0,1,0,83,83
Juuli,0,1,0,1072,1072
Juulia,0,1,0,6218,6218
Juulianna,0,1,0,62,62
Juuli-Anna,0,1,0,16,16
Juuli-Maria,0,1,0,11,11
Juuliska,0,1,0,12,12
Juuni,0,1,0,15,15
Juusa,1,0,15,0,15
Juuse,1,0,77,0,77
Juuso,1,0,10394,0,10394
Juuso-Matias,1,0,11,0,11
Juusonpoika,1,0,20,0,20
Juuso-Pekka,1,0,18,0,18
Juuso-Petteri,1,0,33,0,33
Jymy,1,0,48,0,48
Jyri,1,0,4489,0,4489
Jyri-Matti,1,0,25,0,25
Jyrinpoika,1,0,35,0,35
Jyri-Pekka,1,0,80,0,80
Jyri-Petri,1,0,12,0,12
Jyri-Petteri,1,0,38,0,38
Jyrki,1,0,10126,0,10126
Jyrkinpoika,1,0,64,0,64
Jyrkintytär,0,1,0,21,21
Jyrki-Pekka,1,0,11,0,11
Jyry,1,0,173,0,173
Jytte,0,1,0,12,12
Jyväs,1,0,10,0,10
Ka,0.540540540540541,0.459459459459459,20,17,37
Kaaleb,1,0,12,0,12
Kaaleppi,1,0,20,0,20
Kaan,1,0,35,0,35
Kaaperi,1,0,13,0,13
Kaapo,1,0,1897,0,1897
Kaappo,1,0,65,0,65
Kaapre,1,0,10,0,10
Kaapriel,1,0,61,0,61
Kaaprieli,1,0,17,0,17
Kaapro,1,0,82,0,82
Kaarel,1,0,12,0,12
Kaaren,0,1,0,13,13
Kaari,0,1,0,91,91
Kaariina,0,1,0,21,21
Kaarin,0,1,0,1246,1246
Kaarina,0,1,0,102534,102534
Kaarl,1,0,12,0,12
Kaarle,1,0,1654,0,1654
Kaarlo,1,0,10057,0,10057
Kaarlonpoika,1,0,11,0,11
Kaarna,0,1,0,22,22
Kaarne,1,0,17,0,17
Kaddy,0,1,0,10,10
Kader,1,0,13,0,13
Kadhim,1,0,15,0,15
Kadi,0,1,0,13,13
Kadir,1,0,35,0,35
Kadri,0.344827586206897,0.655172413793103,10,19,29
Kadriye,0,1,0,10,10
Kai,0.998918568184276,0.00108143181572402,9237,10,9247
Kaia,0,1,0,10,10
Kai-Eerik,1,0,16,0,16
Kai-Erik,1,0,44,0,44
Kaiho,0.432432432432432,0.567567567567568,32,42,74
Kaija,0,1,0,14762,14762
Kaija-Helena,0,1,0,13,13
Kaijaleena,0,1,0,12,12
Kaija-Leena,0,1,0,289,289
Kaija-Liisa,0,1,0,255,255
Kaija-Maija,0,1,0,15,15
Kaija-Riitta,0,1,0,79,79
Kaija-Sisko,0,1,0,11,11
Kaiju,0,1,0,64,64
Kai-Juhani,1,0,14,0,14
Kaijus,1,0,24,0,24
Kaika,0,1,0,14,14
Kai-Kristian,1,0,28,0,28
Kaiku,1,0,34,0,34
Kaila,0,1,0,13,13
Kai-Markus,1,0,27,0,27
Kai-Mikael,1,0,27,0,27
Kaimo,1,0,19,0,19
Kain,1,0,11,0,11
Kaino,0.384959046909903,0.615040953090097,517,826,1343
Kainpoika,1,0,50,0,50
Kaintytär,0,1,0,15,15
Kai-Pekka,1,0,19,0,19
Kai-Petri,1,0,11,0,11
Kai-Petteri,1,0,21,0,21
Kaipio,1,0,10,0,10
Kaire,0,1,0,10,10
Kairi,0,1,0,10,10
Kaisa,0,1,0,20004,20004
Kaisa-Elina,0,1,0,13,13
Kaisa-Helena,0,1,0,10,10
Kaisaleena,0,1,0,25,25
Kaisa-Leena,0,1,0,181,181
Kaisaliisa,0,1,0,11,11
Kaisa-Liisa,0,1,0,122,122
Kaisa-Maaria,0,1,0,15,15
Kaisamaija,0,1,0,10,10
Kaisa-Maija,0,1,0,57,57
Kaisamari,0,1,0,21,21
Kaisa-Mari,0,1,0,90,90
Kaisamaria,0,1,0,18,18
Kaisa-Maria,0,1,0,159,159
Kaisa-Marja,0,1,0,21,21
Kaisa-Reeta,0,1,0,13,13
Kaisa-Reetta,0,1,0,19,19
Kaisa-Riitta,0,1,0,16,16
Kaisi,0,1,0,33,33
Kaisla,0,1,0,1513,1513
Kaisla-Kerttu,0,1,0,11,11
Kaisla-Maria,0,1,0,14,14
Kaisli,0,1,0,64,64
Kaisu,0,1,0,4245,4245
Kaisu-Leena,0,1,0,56,56
Kaisu-Liisa,0,1,0,13,13
Kaitlin,0,1,0,11,11
Kaitlyn,0,1,0,18,18
Kaius,1,0,454,0,454
Kaj,1,0,4430,0,4430
Kaja,0,1,0,28,28
Kaj-Erik,1,0,166,0,166
Kaj-Gunnar,1,0,14,0,14
Kaj-Gustav,1,0,15,0,15
Kaj-Henrik,1,0,14,0,14
Kaj-Johan,1,0,14,0,14
Kaj-Kristian,1,0,12,0,12
Kaj-Mikael,1,0,20,0,20
Kajo,1,0,17,0,17
Kaj-Ole,1,0,11,0,11
Kaj-Olof,1,0,29,0,29
Kajsa,0,1,0,329,329
Kajus,1,0,17,0,17
Kale,1,0,26,0,26
Kaleb,1,0,25,0,25
Kalervo,1,0,41220,0,41220
Kalev,1,0,18,0,18
Kaleva,1,0,2238,0,2238
Kalevi,1,0,101614,0,101614
Kalevinpoika,1,0,20,0,20
Kalid,1,0,13,0,13
Kalinka,0,1,0,10,10
Kalla,0,1,0,23,23
Kallas,1,0,18,0,18
Kalle,1,0,18108,0,18108
Kalle-Antti,1,0,21,0,21
Kalle-Eemeli,1,0,18,0,18
Kalle-Juhani,1,0,19,0,19
Kalle-Kustaa,1,0,12,0,12
Kalle-Markus,1,0,11,0,11
Kalle-Matti,1,0,28,0,28
Kallenpoika,1,0,68,0,68
Kallentytär,0,1,0,14,14
Kalle-Oskari,1,0,22,0,22
Kalle-Pekka,1,0,108,0,108
Kalle-Petteri,1,0,34,0,34
Kalle-Valtteri,1,0,12,0,12
Kalle-Veikko,1,0,13,0,13
Kalle-Ville,1,0,19,0,19
Kaltrina,0,1,0,11,11
Kamal,0.855263157894737,0.144736842105263,65,11,76
Kamau,1,0,11,0,11
Kamel,1,0,15,0,15
Kami,1,0,13,0,13
Kamil,1,0,40,0,40
Kamila,0,1,0,29,29
Kamilla,0,1,0,379,379
Kamomilla,0,1,0,70,70
Kamran,1,0,24,0,24
Kamu,1,0,15,0,15
Kane,1,0,10,0,10
Kaneli,0,1,0,150,150
Kanerva,0.0149253731343284,0.985074626865672,20,1320,1340
Kanervo,1,0,26,0,26
Kang,1,0,14,0,14
Kapriel,1,0,11,0,11
Kara,0,1,0,30,30
Karam,1,0,16,0,16
Karan,1,0,13,0,13
Kare,1,0,268,0,268
Kåre,1,0,28,0,28
Kareem,1,0,20,0,20
Karel,1,0,86,0,86
Karela,0,1,0,13,13
Karelia,0,1,0,262,262
Karen,0,1,0,221,221
Kareniina,0,1,0,10,10
Karenina,0,1,0,58,58
Karhu,1,0,13,0,13
Kari,0.999785949740999,0.000214050259000813,46708,10,46718
Kari-Antti,1,0,11,0,11
Kariina,0,1,0,71,71
Kariitta,0,1,0,30,30
Kari-Juhani,1,0,36,0,36
Kari-Jukka,1,0,20,0,20
Kari-Jussi,1,0,18,0,18
Karim,0.975429975429975,0.0245700245700246,397,10,407
Karima,0,1,0,37,37
Karimatti,1,0,10,0,10
Kari-Matti,1,0,189,0,189
Karin,0,1,0,3744,3744
Karina,0,1,0,487,487
Karine,0,1,0,26,26
Karinpoika,1,0,284,0,284
Karintytär,0,1,0,82,82
Karipekka,1,0,13,0,13
Kari-Pekka,1,0,485,0,485
Kari-Petteri,1,0,22,0,22
Karissa,0,1,0,23,23
Karita,0,1,0,2499,2499
Kari-Tapio,1,0,34,0,34
Karitta,0,1,0,19,19
Kari-Veikko,1,0,11,0,11
Karl,1,0,8466,0,8466
Karla,0,1,0,405,405
Karl-Anders,1,0,26,0,26
Karl-Anton,1,0,19,0,19
Karl-August,1,0,12,0,12
Karl-Axel,1,0,26,0,26
Karl-Emil,1,0,16,0,16
Karl-Erik,1,0,492,0,492
Karl-Fredrik,1,0,17,0,17
Karl-Göran,1,0,22,0,22
Karl-Gunnar,1,0,31,0,31
Karl-Gustaf,1,0,41,0,41
Karl-Gustav,1,0,225,0,225
Karl-Henrik,1,0,102,0,102
Karliina,0,1,0,13,13
Karl-Johan,1,0,417,0,417
Karl-Kristian,1,0,15,0,15
Karl-Magnus,1,0,23,0,23
Karl-Mikael,1,0,29,0,29
Karlo,1,0,134,0,134
Karl-Olof,1,0,37,0,37
Karlos,1,0,45,0,45
Karl-Oskar,1,0,46,0,46
Karlotta,0,1,0,22,22
Karmen,0,1,0,23,23
Karo,0.96011396011396,0.0398860398860399,337,14,351
Karol,1,0,25,0,25
Karola,0,1,0,272,272
Karoliina,0,1,0,29954,29954
Karolin,0,1,0,46,46
Karolina,0,1,0,1731,1731
Karoline,0,1,0,92,92
Karolus,1,0,64,0,64
Karpalo,0,1,0,42,42
Karrar,1,0,23,0,23
Karri,1,0,1782,0,1782
Karrinpoika,1,0,11,0,11
Karri-Pekka,1,0,11,0,11
Karsten,1,0,23,0,23
Karwan,1,0,22,0,22
Karzan,1,0,11,0,11
Kasandra,0,1,0,18,18
Kasem,1,0,13,0,13
Kasim,1,0,25,0,25
Kasimiira,0,1,0,10,10
Kasimir,1,0,1107,0,1107
Kasmiira,0,1,0,12,12
Kasmir,1,0,70,0,70
Kasmira,0,1,0,29,29
Kaspar,1,0,130,0,130
Kasper,1,0,5172,0,5172
Kasperi,1,0,4847,0,4847
Kasperiina,0,1,0,12,12
Kaspian,1,0,364,0,364
Kassandra,0,1,0,23,23
Kassius,1,0,14,0,14
Kassu,1,0,31,0,31
Kastanja,0,1,0,149,149
Kaste,0,1,0,22,22
Kastehelmi,0,1,0,737,737
Kaste-Helmi,0,1,0,38,38
Kasten,1,0,19,0,19
Kastriot,1,0,11,0,11
Kata,0,1,0,149,149
Kataliina,0,1,0,10,10
Katalin,0,1,0,33,33
Katariina,0,1,0,47413,47413
Kata-Riina,0,1,0,11,11
Katarina,0,1,0,5533,5533
Katarine,0,1,0,65,65
Katarzyna,0,1,0,23,23
Kate,0,1,0,121,121
Kateriina,0,1,0,59,59
Katerina,0,1,0,191,191
Katerine,0,1,0,12,12
Kateryna,0,1,0,12,12
Katharina,0,1,0,381,381
Katharine,0,1,0,37,37
Käthe,0,1,0,57,57
Katherina,0,1,0,22,22
Katherine,0,1,0,161,161
Kathleen,0,1,0,88,88
Kathrin,0,1,0,29,29
Kathrina,0,1,0,16,16
Kathrine,0,1,0,28,28
Kathryn,0,1,0,33,33
Kathy,0,1,0,29,29
Kati,0,1,0,11067,11067
Katia,0,1,0,68,68
Katianna,0,1,0,11,11
Katie,0,1,0,42,42
Kati-Johanna,0,1,0,22,22
Kati-Maarit,0,1,0,12,12
Kati-Mari,0,1,0,12,12
Kati-Maria,0,1,0,23,23
Katina,0,1,0,18,18
Katinka,0,1,0,200,200
Kati-Susanna,0,1,0,15,15
Katja,0,1,0,17128,17128
Katjaana,0,1,0,106,106
Katja-Helena,0,1,0,14,14
Katja-Leena,0,1,0,28,28
Katja-Liisa,0,1,0,15,15
Katja-Maaria,0,1,0,18,18
Katja-Maarit,0,1,0,21,21
Katja-Mari,0,1,0,22,22
Katja-Maria,0,1,0,58,58
Katja-Marika,0,1,0,16,16
Katjana,0,1,0,11,11
Katju,0,1,0,47,47
Katjusa,0,1,0,11,11
Katjusha,0,1,0,13,13
Katjuska,0,1,0,41,41
Katleena,0,1,0,19,19
Kätlin,0,1,0,14,14
Katri,0,1,0,15515,15515
Katrianna,0,1,0,21,21
Katri-Elina,0,1,0,10,10
Katri-Helena,0,1,0,186,186
Katriina,0,1,0,20857,20857
Katriine,0,1,0,11,11
Katri-Johanna,0,1,0,13,13
Katri-Maria,0,1,0,64,64
Katrin,0,1,0,365,365
Katrina,0,1,0,867,867
Katrine,0,1,0,149,149
Katy,0,1,0,35,35
Katya,0,1,0,34,34
Kauko,1,0,10687,0,10687
Kaukomieli,1,0,22,0,22
Kaukonpoika,1,0,25,0,25
Kauno,1,0,753,0,753
Kaur,0,1,0,98,98
Kauri,1,0,172,0,172
Kaveh,1,0,12,0,12
Kavita,0,1,0,10,10
Kawa,1,0,23,0,23
Kawsar,0,1,0,15,15
Kawthar,0,1,0,10,10
Kay,0.557894736842105,0.442105263157895,53,42,95
Kaya,0,1,0,14,14
Kayla,0,1,0,38,38
Kea,0,1,0,42,42
Keanu,1,0,10,0,10
Kebba,1,0,11,0,11
Keea,0,1,0,10,10
Keesia,0,1,0,14,14
Keijo,1,0,10967,0,10967
Keijonpoika,1,0,20,0,20
Keiju,0,1,0,110,110
Keijukka,0,1,0,55,55
Keimo,1,0,121,0,121
Keira,0,1,0,22,22
Keith,1,0,62,0,62
Kelly,0,1,0,59,59
Kelpo,1,0,32,0,32
Kelvin,1,0,19,0,19
Kemal,1,0,47,0,47
Ken,1,0,206,0,206
Kenan,1,0,32,0,32
Kendra,0,1,0,22,22
Keni,1,0,53,0,53
Kennet,1,0,331,0,331
Kenneth,1,0,2262,0,2262
Kenny,1,0,114,0,114
Kent,1,0,509,0,509
Kenth,1,0,91,0,91
Kenza,0,1,0,10,10
Kerem,1,0,22,0,22
Keren,0,1,0,20,20
Kerim,1,0,28,0,28
Kerkko,1,0,233,0,233
Kerli,0,1,0,16,16
Kersti,0,1,0,69,69
Kerstin,0,1,0,1686,1686
Kert,1,0,11,0,11
Kerttu,0,1,0,13029,13029
Kerttu-Kaarina,0,1,0,19,19
Kerttuli,0,1,0,887,887
Kerttu-Liisa,0,1,0,40,40
Kesäheinä,0,1,0,28,28
Kesia,0,1,0,43,43
Keth,0,1,0,14,14
Ketsia,0,1,0,12,12
Kettil,1,0,12,0,12
Kevät,0,1,0,21,21
Kevin,1,0,1159,0,1159
Kezia,0,1,0,10,10
Kha,0,1,0,10,10
Khaalid,1,0,11,0,11
Khac,1,0,12,0,12
Khadar,0.6875,0.3125,33,15,48
Khadija,0,1,0,74,74
Khadra,0,1,0,46,46
Khadro,0,1,0,11,11
Khalaf,1,0,10,0,10
Khaled,0.808080808080808,0.191919191919192,80,19,99
Khalid,0.892655367231638,0.107344632768362,158,19,177
Khalif,0.483870967741935,0.516129032258065,15,16,31
Khalil,1,0,51,0,51
Khamis,1,0,10,0,10
Khan,1,0,21,0,21
Khang,1,0,30,0,30
Khanh,0.5,0.5,21,21,42
Khoa,1,0,18,0,18
Kia,0,1,0,1663,1663
Kia-Maria,0,1,0,30,30
Kian,1,0,79,0,79
Kiana,0,1,0,78,78
Kianna,0,1,0,20,20
Kiara,0,1,0,106,106
Kid,1,0,10,0,10
Kide,0,1,0,12,12
Kie,1,0,17,0,17
Kielo,0,1,0,745,745
Kien,1,0,21,0,21
Kieran,1,0,18,0,18
Kiet,1,0,18,0,18
Kieu,0,1,0,28,28
Kiia,0,1,0,2523,2523
Kiia-Maria,0,1,0,33,33
Kiira,0,1,0,1254,1254
Kiisa,0,1,0,34,34
Kiki,0,1,0,25,25
Kikka,0,1,0,59,59
Kilian,1,0,39,0,39
Kille,1,0,11,0,11
Kim,0.960528603721092,0.039471396278908,5524,227,5751
Kimberly,0,1,0,33,33
Kim-Erik,1,0,26,0,26
Kimete,0,1,0,12,12
Kim-Henrik,1,0,13,0,13
Kimi,1,0,1437,0,1437
Kiminpoika,1,0,12,0,12
Kim-Johan,1,0,13,0,13
Kim-Mikael,1,0,10,0,10
Kimmo,1,0,16341,0,16341
Kimmonpoika,1,0,83,0,83
Kimmontytär,0,1,0,27,27
Kim-Peter,1,0,11,0,11
Kimsdotter,0,1,0,18,18
Kinga,0,1,0,14,14
Kingsley,1,0,15,0,15
Kira,0,1,0,899,899
Kiran,1,0,11,0,11
Kiri,1,0,15,0,15
Kiril,1,0,94,0,94
Kirill,1,0,164,0,164
Kirka,1,0,26,0,26
Kirke,0,1,0,16,16
Kirmo,1,0,53,0,53
Kirsi,0,1,0,21861,21861
Kirsi-Hannele,0,1,0,13,13
Kirsikka,0,1,0,1082,1082
Kirsi-Leena,0,1,0,34,34
Kirsi-Liisa,0,1,0,12,12
Kirsi-Maaria,0,1,0,43,43
Kirsi-Maarit,0,1,0,91,91
Kirsi-Maija,0,1,0,25,25
Kirsimari,0,1,0,10,10
Kirsi-Mari,0,1,0,71,71
Kirsimaria,0,1,0,25,25
Kirsi-Maria,0,1,0,391,391
Kirsi-Marie,0,1,0,11,11
Kirsi-Marika,0,1,0,12,12
Kirsimarja,0,1,0,96,96
Kirsi-Marja,0,1,0,1441,1441
Kirsi-Marjaana,0,1,0,13,13
Kirsi-Marjo,0,1,0,17,17
Kirsi-Marjut,0,1,0,29,29
Kirsten,0,1,0,73,73
Kirsti,0,1,0,17166,17166
Kirstiina,0,1,0,17,17
Kirsti-Kaarina,0,1,0,15,15
Kirsti-Liisa,0,1,0,58,58
Kirsti-Maija,0,1,0,10,10
Kirstin,0,1,0,11,11
Kirta,0,1,0,39,39
Kit,1,0,19,0,19
Kiti,0,1,0,190,190
Kitta,0,1,0,59,59
Kitte,0,1,0,37,37
Kitti,0,1,0,12,12
Kitty,0,1,0,122,122
Kiuru,0,1,0,22,22
Kivi,1,0,61,0,61
Kjell,1,0,1036,0,1036
Kjell-Erik,1,0,28,0,28
Kjell-Ove,1,0,12,0,12
Kjerstin,0,1,0,17,17
Klaara,0,1,0,279,279
Klaes,1,0,10,0,10
Klara,0,1,0,290,290
Klarissa,0,1,0,15,15
Klas,1,0,521,0,521
Klas-Erik,1,0,24,0,24
Klas-Göran,1,0,23,0,23
Klaudia,0,1,0,400,400
Klaus,1,0,2458,0,2458
Klaus-Erik,1,0,11,0,11
Klemens,1,0,16,0,16
Klemetti,1,0,25,0,25
Knut,1,0,409,0,409
Knutsson,1,0,18,0,18
Knuut,1,0,11,0,11
Koda,1,0,11,0,11
Kofi,1,0,31,0,31
Koitto,1,0,57,0,57
Kojo,1,0,14,0,14
Konrad,1,0,320,0,320
Konsta,1,0,4609,0,4609
Konstantia,0,1,0,14,14
Konstantin,1,0,865,0,865
Konstantina,0,1,0,16,16
Konstantinos,1,0,78,0,78
Köpi,1,0,10,0,10
Kosma,1,0,23,0,23
Kosmo,1,0,104,0,104
Kosmos,1,0,17,0,17
Kössi,1,0,17,0,17
Kosti,1,0,1561,0,1561
Kostia,1,0,65,0,65
Kostian,1,0,11,0,11
Kotivalo,0.557377049180328,0.442622950819672,34,27,61
Kouta,1,0,20,0,20
Kreeta,0,1,0,420,420
Kreetta,0,1,0,481,481
Kreetta-Liisa,0,1,0,12,12
Krenare,0,1,0,12,12
Kreta,0,1,0,16,16
Kris,1,0,33,0,33
Krishna,1,0,16,0,16
Krisse,0.288461538461538,0.711538461538462,15,37,52
Krista,0,1,0,6571,6571
Kristal,0,1,0,15,15
Krista-Maria,0,1,0,42,42
Kristel,0,1,0,214,214
Kristella,0,1,0,57,57
Kristen,0.304347826086957,0.695652173913043,21,48,69
Krister,1,0,2729,0,2729
Kristi,0,1,0,27,27
Kristian,0.999710648148148,0.000289351851851852,51825,15,51840
Kristiana,0,1,0,16,16
Kristianna,0,1,0,13,13
Kristiin,0,1,0,13,13
Kristiina,0,1,0,74493,74493
Kristiine,0,1,0,34,34
Kristin,0,1,0,366,366
Kristina,0,1,0,11861,11861
Kristine,0,1,0,511,511
Kristjan,1,0,59,0,59
Kristo,1,0,259,0,259
Kristof,1,0,17,0,17
Kristofer,1,0,321,0,321
Kristoffer,1,0,1198,0,1198
Kristopher,1,0,43,0,43
Kristy,0,1,0,13,13
Krisztina,0,1,0,13,13
Krystyna,0,1,0,24,24
Krzysztof,1,0,14,0,14
Ksenia,0,1,0,237,237
Ksenija,0,1,0,30,30
Ksenja,0,1,0,18,18
Kübra,0,1,0,12,12
Kuisma,1,0,344,0,344
Kukka,0,1,0,690,690
Kukkamaaria,0,1,0,51,51
Kukka-Maaria,0,1,0,727,727
Kukka-Maria,0,1,0,86,86
Kullervo,1,0,10789,0,10789
Kulta,0,1,0,16,16
Kultimo,1,0,12,0,12
Kumar,1,0,70,0,70
Kumari,0,1,0,21,21
Kunnar,1,0,16,0,16
Kunnari,1,0,81,0,81
Kuno,1,0,15,0,15
Kunto,1,0,146,0,146
Kurt,1,0,2023,0,2023
Kurt-Erik,1,0,40,0,40
Kushtrim,1,0,12,0,12
Kustaa,1,0,5534,0,5534
Kustaava,0,1,0,453,453
Kustava,0,1,0,11,11
Kustavi,1,0,58,0,58
Kusti,1,0,412,0,412
Kuu,0.333333333333333,0.666666666666667,14,28,42
Kuuno,1,0,28,0,28
Kuura,0.652173913043478,0.347826086956522,75,40,115
Kuutar,0,1,0,22,22
Kuutti,1,0,236,0,236
Kwabena,1,0,15,0,15
Kwaku,1,0,15,0,15
Kwame,1,0,21,0,21
Kwan,1,0,10,0,10
Kweku,1,0,10,0,10
Kwesi,1,0,10,0,10
Kwok,1,0,11,0,11
Kyle,1,0,47,0,47
Kylie,0,1,0,10,10
Kylli,0,1,0,62,62
Kyllikki,0,1,0,40001,40001
Kyösti,1,0,4618,0,4618
Kyöstinpoika,1,0,13,0,13
Kyra,0,1,0,19,19
Kyrö,1,0,10,0,10
La,0,1,0,15,15
Lada,0,1,0,12,12
Laetitia,0,1,0,16,16
Lahcen,1,0,11,0,11
Lahja,0.00952972860990263,0.990470271390097,46,4781,4827
Lai,0,1,0,10,10
Laia,0,1,0,21,21
Laila,0,1,0,4631,4631
Laimi,0,1,0,356,356
Laina,0,1,0,1974,1974
Laine,0.113636363636364,0.886363636363636,10,78,88
Laini,0,1,0,17,17
Lajos,1,0,18,0,18
Lakshmi,0,1,0,11,11
Lalita,0,1,0,13,13
Lalla,0,1,0,12,12
Lalli,1,0,81,0,81
Lam,0.7,0.3,28,12,40
Lambert,1,0,18,0,18
Lamia,0,1,0,14,14
Lamin,1,0,55,0,55
Lamine,1,0,12,0,12
Lan,0,1,0,63,63
Lana,0,1,0,59,59
Lancelot,1,0,10,0,10
Lani,0,1,0,10,10
Lara,0,1,0,465,465
Larbi,1,0,11,0,11
Lare,1,0,11,0,11
Lari,1,0,1954,0,1954
Lari-Matti,1,0,21,0,21
Lari-Pekka,1,0,46,0,46
Lari-Petteri,1,0,10,0,10
Larisa,0,1,0,200,200
Larissa,0,1,0,604,604
Larri,1,0,30,0,30
Larry,1,0,49,0,49
Lars,1,0,5437,0,5437
Lars-Åke,1,0,33,0,33
Lars-Anders,1,0,16,0,16
Larsdotter,0,1,0,35,35
Lars-Eric,1,0,37,0,37
Lars-Erik,1,0,372,0,372
Lars-Göran,1,0,55,0,55
Lars-Gunnar,1,0,16,0,16
Lars-Gustav,1,0,13,0,13
Lars-Henrik,1,0,38,0,38
Lars-Johan,1,0,99,0,99
Lars-Mikael,1,0,14,0,14
Lars-Ole,1,0,17,0,17
Lars-Olof,1,0,61,0,61
Lars-Ove,1,0,16,0,16
Lars-Peter,1,0,16,0,16
Larsson,1,0,23,0,23
Lasse,1,0,10512,0,10512
Lassenpoika,1,0,39,0,39
Lassentytär,0,1,0,10,10
Lasse-Pekka,1,0,28,0,28
Lassi,1,0,5683,0,5683
Lassi-Matti,1,0,12,0,12
Lassinpoika,1,0,15,0,15
Lassi-Pekka,1,0,56,0,56
Laszlo,1,0,11,0,11
László,1,0,28,0,28
Latif,1,0,20,0,20
Latifa,0,1,0,18,18
Lauha,0,1,0,148,148
Laulikki,0,1,0,17,17
Launo,1,0,97,0,97
Laura,0,1,0,26892,26892
Laura-Elina,0,1,0,22,22
Laura-Emilia,0,1,0,25,25
Laura-Kaisa,0,1,0,54,54
Laura-Leena,0,1,0,17,17
Laura-Liisa,0,1,0,21,21
Laura-Maija,0,1,0,32,32
Laura-Mari,0,1,0,14,14
Laura-Maria,0,1,0,152,152
Laura-Sofia,0,1,0,18,18
Laure,0,1,0,22,22
Lauren,0,1,0,86,86
Laurence,1,0,16,0,16
Laurent,1,0,37,0,37
Laurentius,1,0,30,0,30
Lauri,1,0,35854,0,35854
Lauriina,0,1,0,358,358
Lauri-Juhani,1,0,16,0,16
Lauri-Matti,1,0,30,0,30
Laurinpoika,1,0,108,0,108
Laurintytär,0,1,0,27,27
Lauri-Pekka,1,0,44,0,44
Lavinia,0,1,0,37,37
Lawrence,1,0,74,0,74
Layla,0,1,0,52,52
Le,0.333333333333333,0.666666666666667,34,68,102
Lea,0,1,0,12964,12964
Léa,0,1,0,25,25
Leah,0,1,0,101,101
Lea-Liisa,0,1,0,17,17
Leana,0,1,0,15,15
Leander,1,0,759,0,759
Leandra,0,1,0,22,22
Leandro,1,0,14,0,14
Leanna,0,1,0,60,60
Leanne,0,1,0,24,24
Leanteri,1,0,13,0,13
Leart,1,0,11,0,11
Ledion,1,0,10,0,10
Lee,0.631578947368421,0.368421052631579,216,126,342
Leea,0,1,0,1390,1390
Leea-Maria,0,1,0,11,11
Leela,0,1,0,12,12
Leelia,0,1,0,13,13
Leena,0,1,0,50194,50194
Leena-Anneli,0,1,0,19,19
Leena-Kaarina,0,1,0,42,42
Leenakaisa,0,1,0,17,17
Leena-Kaisa,0,1,0,144,144
Leena-Liisa,0,1,0,15,15
Leena-Maarit,0,1,0,13,13
Leenamaija,0,1,0,24,24
Leena-Maija,0,1,0,377,377
Leenamari,0,1,0,13,13
Leena-Mari,0,1,0,39,39
Leena-Maria,0,1,0,69,69
Leena-Marja,0,1,0,69,69
Leena-Marjatta,0,1,0,32,32
Leena-Riitta,0,1,0,33,33
Leena-Sisko,0,1,0,34,34
Leene,0,1,0,13,13
Leeni,0,1,0,398,398
Leenu,0,1,0,27,27
Leevi,1,0,9088,0,9088
Lei,0.333333333333333,0.666666666666667,11,22,33
Leia,0,1,0,94,94
Leida,0,1,0,12,12
Leif,1,0,3308,0,3308
Leif-Åke,1,0,10,0,10
Leif-Erik,1,0,36,0,36
Leif-Johan,1,0,14,0,14
Leigh,0,1,0,30,30
Leija,0,1,0,61,61
Leijonamieli,1,0,14,0,14
Leila,0,1,0,12216,12216
Leili,0,1,0,10,10
Leimu,1,0,39,0,39
Leini,0,1,0,10,10
Leinikki,0,1,0,16,16
Leino,1,0,152,0,152
Lejla,0,1,0,23,23
Lembi,0,1,0,11,11
Lembit,1,0,12,0,12
Lemmikki,0,1,0,916,916
Lemmitty,0,1,0,482,482
Lemmy,1,0,96,0,96
Lempi,0,1,0,2451,2451
Lena,0,1,0,1710,1710
Lena-Maria,0,1,0,25,25
Lene,0,1,0,69,69
Leni,0.0923694779116466,0.907630522088353,23,226,249
Lenita,0,1,0,551,551
Lenna,1,0,69,0,69
Lennard,1,0,50,0,50
Lennart,1,0,2462,0,2462
Lenne,1,0,84,0,84
Lenni,1,0,3052,0,3052
Lenni-Kalle,1,0,22,0,22
Lennon,1,0,23,0,23
Lennox,1,0,13,0,13
Lennu,1,0,61,0,61
Lenny,0.903225806451613,0.0967741935483871,140,15,155
Leo,1,0,15078,0,15078
Léo,1,0,27,0,27
Leo-Matti,1,0,11,0,11
Leon,1,0,761,0,761
Léon,1,0,34,0,34
León,1,0,17,0,17
Leona,0,1,0,386,386
Leonard,1,0,1715,0,1715
Leonardo,1,0,284,0,284
Leone,0.25,0.75,10,30,40
Leonel,1,0,81,0,81
Leonhard,1,0,32,0,32
Leoni,0,1,0,10,10
Leonid,1,0,107,0,107
Leonidas,1,0,32,0,32
Leonidovna,0,1,0,16,16
Leonie,0,1,0,62,62
Leonilla,0,1,0,14,14
Leonita,0,1,0,12,12
Leonna,0,1,0,20,20
Leonoora,0,1,0,23,23
Leonor,0,1,0,14,14
Leonora,0,1,0,189,189
Leonore,0,1,0,23,23
Leonpoika,1,0,17,0,17
Leontina,0,1,0,10,10
Leontine,0,1,0,33,33
Leo-Pekka,1,0,21,0,21
Leopold,1,0,298,0,298
Leroy,1,0,20,0,20
Leslie,0.525,0.475,21,19,40
Leticia,0,1,0,24,24
Lev,1,0,37,0,37
Levent,1,0,13,0,13
Levente,1,0,11,0,11
Levi,1,0,280,0,280
Levina,0,1,0,14,14
Lewis,1,0,41,0,41
Lex,1,0,16,0,16
Leyla,0,1,0,95,95
Li,0.0581395348837209,0.941860465116279,10,162,172
Lia,0,1,0,267,267
Liam,1,0,612,0,612
Lian,0,1,0,13,13
Liana,0,1,0,133,133
Liane,0,1,0,11,11
Liang,1,0,12,0,12
Lianna,0,1,0,47,47
Liban,0.75,0.25,63,21,84
Lida,0,1,0,43,43
Lidia,0,1,0,399,399
Lidija,0,1,0,24,24
Liekki,1,0,13,0,13
Lien,0,1,0,31,31
Lieu,0,1,0,10,10
Lii,0,1,0,22,22
Liia,0,1,0,248,248
Liibaan,1,0,24,0,24
Liiban,1,0,21,0,21
Liida,0,1,0,91,91
Liidia,0,1,0,62,62
Liila,0,1,0,44,44
Liilia,0,1,0,30,30
Liina,0,1,0,1851,1851
Liina-Kaisa,0,1,0,11,11
Liina-Lotta,0,1,0,24,24
Liina-Maija,0,1,0,17,17
Liina-Maria,0,1,0,21,21
Liine,0,1,0,21,21
Liini,0,1,0,14,14
Liinu,0,1,0,453,453
Liinus,1,0,122,0,122
Liis,0,1,0,14,14
Liisa,0,1,0,72600,72600
Liisa-Kaarina,0,1,0,12,12
Liisa-Lotta,0,1,0,19,19
Liisa-Maaria,0,1,0,10,10
Liisamaija,0,1,0,24,24
Liisa-Maija,0,1,0,73,73
Liisamari,0,1,0,13,13
Liisa-Mari,0,1,0,22,22
Liisamaria,0,1,0,16,16
Liisa-Maria,0,1,0,137,137
Liisa-Marja,0,1,0,15,15
Liisa-Marjatta,0,1,0,13,13
Liise,0,1,0,22,22
Liisi,0,1,0,1247,1247
Liisu,0,1,0,60,60
Liisukka,0,1,0,20,20
Liivia,0,1,0,30,30
Lija,0,1,0,14,14
Lila,0,1,0,698,698
Lili,0,1,0,432,432
Lilia,0,1,0,709,709
Lilian,0,1,0,1635,1635
Liliana,0,1,0,114,114
Liliane,0,1,0,25,25
Liliann,0,1,0,17,17
Lili-Ann,0,1,0,14,14
Lilianna,0,1,0,63,63
Lilija,0,1,0,30,30
Lilith,0,1,0,25,25
Liliya,0,1,0,16,16
Lilja,0,1,0,6598,6598
Liljaana,0,1,0,17,17
Lilja-Maria,0,1,0,25,25
Liljan,0,1,0,15,15
Liljen,0,1,0,12,12
Lill,0,1,0,24,24
Lilla,0,1,0,48,48
Lillan,0,1,0,11,11
Lillebror,1,0,27,0,27
Lillemor,0,1,0,284,284
Lille-Mor,0,1,0,19,19
Lillevi,0,1,0,11,11
Lilli,0,1,0,2041,2041
Lillian,0,1,0,126,126
Lilly,0,1,0,333,333
Lilo,0,1,0,14,14
Lily,0,1,0,449,449
Lilya,0,1,0,25,25
Lilyan,0,1,0,11,11
Lin,0.19672131147541,0.80327868852459,12,49,61
Lina,0,1,0,1051,1051
Linda,0,1,0,7585,7585
Linda-Lotta,0,1,0,15,15
Linda-Mari,0,1,0,22,22
Linda-Maria,0,1,0,128,128
Linda-Marie,0,1,0,36,36
Linda-Sofia,0,1,0,15,15
Lindis,0,1,0,11,11
Lindsay,0,1,0,13,13
Line,0,1,0,71,71
Linea,0,1,0,112,112
Linéa,0,1,0,46,46
Linette,0,1,0,19,19
Ling,0,1,0,40,40
Linh,0.122641509433962,0.877358490566038,13,93,106
Linn,0,1,0,577,577
Linne,0,1,0,137,137
Linnea,0,1,0,17840,17840
Linnéa,0,1,0,2618,2618
Linnèa,0,1,0,32,32
Lino,1,0,25,0,25
Linus,1,0,1203,0,1203
Lion,1,0,26,0,26
Liona,0,1,0,15,15
Lionel,1,0,107,0,107
Lioubov,0,1,0,55,55
Lioudmila,0,1,0,114,114
Lippe,0,1,0,11,11
Lippo,1,0,72,0,72
Liridona,0,1,0,10,10
Lirije,0,1,0,11,11
Lis,0,1,0,31,31
Lisa,0,1,0,1884,1884
Lisa-Maria,0,1,0,47,47
Lisa-Marie,0,1,0,40,40
Lisbet,0,1,0,490,490
Lisbeth,0,1,0,825,825
Lis-Beth,0,1,0,11,11
Lis-Britt,0,1,0,27,27
Lise,0,1,0,113,113
Lisel,0,1,0,11,11
Liselott,0,1,0,102,102
Lise-Lott,0,1,0,70,70
Liselotte,0,1,0,86,86
Lise-Lotte,0,1,0,89,89
Lise-Maj,0,1,0,27,27
Lisen,0,1,0,176,176
Lisette,0,1,0,167,167
Lisi,0,1,0,18,18
Lis-Maj,0,1,0,13,13
Lis-Mari,0,1,0,27,27
Lis-Marie,0,1,0,34,34
Lissu,0,1,0,27,27
Lita,0,1,0,19,19
Liubov,0,1,0,79,79
Liudmila,0,1,0,159,159
Liv,0,1,0,166,166
Livia,0,1,0,508,508
Liz,0,1,0,27,27
Liza,0,1,0,60,60
Lizette,0,1,0,49,49
Ljuba,0,1,0,18,18
Ljubov,0,1,0,99,99
Ljudmila,0,1,0,174,174
Lloyd,1,0,23,0,23
Lo,0,1,0,19,19
Loan,0,1,0,38,38
Logan,1,0,18,0,18
Loke,1,0,24,0,24
Lola,0,1,0,141,141
Lolan,0,1,0,62,62
Lolita,0,1,0,42,42
Long,1,0,63,0,63
Lonny,0,1,0,11,11
Lora,0,1,0,14,14
Lore,0,1,0,11,11
Lorena,0,1,0,36,36
Lorens,1,0,22,0,22
Lorentz,1,0,60,0,60
Lorenz,1,0,86,0,86
Lorenzo,1,0,71,0,71
Loreta,0,1,0,11,11
Loretta,0,1,0,23,23
Lori,0,1,0,11,11
Lorik,1,0,10,0,10
Lorin,0,1,0,19,19
Lorna,0,1,0,18,18
Lorraine,0,1,0,20,20
Lotfi,1,0,21,0,21
Lothar,1,0,15,0,15
Lotta,0,1,0,10612,10612
Lotta-Emilia,0,1,0,26,26
Lotta-Kaisa,0,1,0,15,15
Lotta-Leena,0,1,0,11,11
Lottaliina,0,1,0,16,16
Lotta-Liina,0,1,0,11,11
Lotta-Liisa,0,1,0,23,23
Lotta-Maaria,0,1,0,26,26
Lotta-Maija,0,1,0,18,18
Lotta-Mari,0,1,0,29,29
Lotta-Maria,0,1,0,91,91
Lotta-Riina,0,1,0,12,12
Lotta-Sofia,0,1,0,25,25
Lotte,0,1,0,234,234
Lotten,0,1,0,42,42
Lou,0,1,0,14,14
Louhi,0,1,0,15,15
Loui,1,0,11,0,11
Louice,0,1,0,22,22
Louie,1,0,11,0,11
Louis,0.936893203883495,0.0631067961165049,193,13,206
Louisa,0,1,0,117,117
Louise,0,1,0,2161,2161
Louna,0,1,0,307,307
Lounatuuli,0,1,0,30,30
Lourdes,0,1,0,18,18
Lova,0,1,0,66,66
Love,0.728395061728395,0.271604938271605,59,22,81
Loviisa,0,1,0,2659,2659
Lovis,0,1,0,34,34
Lovisa,0,1,0,1168,1168
Lowa,0,1,0,15,15
Lowe,1,0,20,0,20
Lu,0,1,0,15,15
Luan,1,0,22,0,22
Luana,0,1,0,20,20
Luc,1,0,19,0,19
Luca,1,0,1564,0,1564
Lucas,1,0,2126,0,2126
Lucia,0,1,0,656,656
Lucian,1,0,13,0,13
Luciana,0,1,0,21,21
Luciano,1,0,33,0,33
Lucie,0,1,0,31,31
Lucien,1,0,21,0,21
Lucille,0,1,0,13,13
Lucina,0,1,0,36,36
Lucinda,0,1,0,26,26
Lucius,1,0,14,0,14
Lucy,0,1,0,81,81
Ludmila,0,1,0,120,120
Ludmilla,0,1,0,13,13
Ludovic,1,0,10,0,10
Ludvig,1,0,458,0,458
Ludvik,1,0,10,0,10
Ludwig,1,0,145,0,145
Luigi,1,0,22,0,22
Luis,1,0,208,0,208
Luisa,0,1,0,125,125
Luise,0,1,0,52,52
Luiz,1,0,12,0,12
Luiza,0,1,0,24,24
Luka,1,0,2640,0,2640
Lukas,1,0,1939,0,1939
Luke,1,0,167,0,167
Lul,0,1,0,10,10
Luljeta,0,1,0,12,12
Lulu,0,1,0,109,109
Lulzim,1,0,11,0,11
Lumi,0,1,0,3071,3071
Lumia,0,1,0,1233,1233
Lumianna,0,1,0,29,29
Lumiella,0,1,0,12,12
Lumihelmi,0,1,0,19,19
Lumi-Helmi,0,1,0,18,18
Lumikirsikka,0,1,0,11,11
Lumikki,0,1,0,395,395
Lumikukka,0,1,0,114,114
Lumi-Kukka,0,1,0,28,28
Lumililja,0,1,0,14,14
Lumi-Lilja,0,1,0,15,15
Lumilla,0,1,0,32,32
Lumi-Maria,0,1,0,24,24
Lumimarja,0,1,0,30,30
Lumina,0,1,0,338,338
Luminea,0,1,0,12,12
Luminia,0,1,0,14,14
Luminka,0,1,0,16,16
Lumituuli,0,1,0,19,19
Lumi-Tuuli,0,1,0,25,25
Lumi-Tuulia,0,1,0,14,14
Lumnije,0,1,0,12,12
Lumo,0,1,0,20,20
Luna,0,1,0,707,707
Luqman,1,0,28,0,28
Lusia,0,1,0,12,12
Lusiina,0,1,0,24,24
Lusina,0,1,0,14,14
Luucas,1,0,12,0,12
Luuka,1,0,16,0,16
Luukas,1,0,2733,0,2733
Luul,0,1,0,12,12
Luz,0,1,0,25,25
Ly,0,1,0,35,35
Lydia,0,1,0,2057,2057
Lydmila,0,1,0,45,45
Lykke,0,1,0,37,37
Lyly,1,0,22,0,22
Lynn,0,1,0,118,118
Lynne,0,1,0,27,27
Lyra,0,1,0,13,13
Lyydi,0,1,0,227,227
Lyydia,0,1,0,4655,4655
Lyyli,0,1,0,1821,1821
Lyylia,0,1,0,17,17
Lyylikki,0,1,0,97,97
Lyyti,0,1,0,255,255
M,1,0,15,0,15
M.,0.647058823529412,0.352941176470588,22,12,34
Maare,0,1,0,59,59
Maaren,0,1,0,52,52
Maaret,0,1,0,4324,4324
Maareta,0,1,0,15,15
Maaretta,0,1,0,53,53
Maari,0,1,0,158,158
Maaria,0,1,0,14871,14871
Maarika,0,1,0,912,912
Maarikka,0,1,0,16,16
Maarit,0,1,0,57815,57815
Maarita,0,1,0,129,129
Maarja,0,1,0,35,35
Maarten,1,0,13,0,13
Maaru,0,1,0,14,14
Mabel,0,1,0,18,18
Mac,1,0,14,0,14
Madelaine,0,1,0,50,50
Madelein,0,1,0,56,56
Madeleine,0,1,0,1095,1095
Madelen,0,1,0,51,51
Madelén,0,1,0,13,13
Madelene,0,1,0,132,132
Madeléne,0,1,0,15,15
Madeline,0,1,0,53,53
Madicken,0,1,0,39,39
Madina,0,1,0,27,27
Madison,0,1,0,31,31
Madleena,0,1,0,37,37
Madlena,0,1,0,12,12
Madonna,0,1,0,22,22
Mae,0,1,0,70,70
Mafalda,0,1,0,13,13
Magda,0,1,0,70,70
Magdaleena,0,1,0,556,556
Magdalena,0,1,0,1218,1218
Magga,0,1,0,12,12
Maggi,0,1,0,10,10
Maggie,0,1,0,32,32
Magne,1,0,14,0,14
Magnhild,0,1,0,21,21
Magnolia,0,1,0,12,12
Magnus,1,0,2390,0,2390
Magnusdotter,0,1,0,17,17
Magnusson,1,0,15,0,15
Mahad,0.762295081967213,0.237704918032787,93,29,122
Mahamed,0.677083333333333,0.322916666666667,195,93,288
Mahamud,0.657407407407407,0.342592592592593,71,37,108
Mahdi,0.826771653543307,0.173228346456693,105,22,127
Maher,1,0,23,0,23
Mahir,1,0,26,0,26
Mahmood,1,0,23,0,23
Mahmoud,0.815384615384615,0.184615384615385,106,24,130
Mahmud,1,0,25,0,25
Mahmut,1,0,15,0,15
Mahnaz,0,1,0,14,14
Mahsa,0,1,0,14,14
Mai,0,1,0,536,536
Maia,0,1,0,244,244
Mai-Brit,0,1,0,12,12
Mai-Britt,0,1,0,36,36
Maida,0,1,0,19,19
Maie,0,1,0,17,17
Maija,0,1,0,32877,32877
Maija-Elina,0,1,0,13,13
Maija-Helena,0,1,0,24,24
Maija-Kaarina,0,1,0,30,30
Maija-Kaisa,0,1,0,57,57
Maijaleena,0,1,0,26,26
Maija-Leena,0,1,0,1043,1043
Maijaliisa,0,1,0,74,74
Maija-Liisa,0,1,0,5439,5439
Maija-Reetta,0,1,0,22,22
Maija-Riikka,0,1,0,16,16
Maija-Riitta,0,1,0,310,310
Maija-Sisko,0,1,0,35,35
Maijastiina,0,1,0,118,118
Maija-Stiina,0,1,0,41,41
Maijastina,0,1,0,16,16
Maija-Stina,0,1,0,10,10
Maijeli,0,1,0,18,18
Maij-Lis,0,1,0,12,12
Maiju,0,1,0,4131,4131
Maijukka,0,1,0,12,12
Maiju-Leena,0,1,0,22,22
Maiju-Liina,0,1,0,13,13
Maiju-Liisa,0,1,0,12,12
Maikki,0,1,0,295,295
Maikku,0,1,0,17,17
Maila,0,1,0,3397,3397
Maile,0,1,0,10,10
Maileena,0,1,0,66,66
Mai-Leena,0,1,0,16,16
Maili,0,1,0,497,497
Mailikki,0,1,0,13,13
Mailis,0,1,0,1329,1329
Mai-Lis,0,1,0,57,57
Maina,0,1,0,15,15
Maini,0,1,0,301,301
Mainikki,0,1,0,90,90
Maininki,0.44,0.56,11,14,25
Mainio,1,0,420,0,420
Maira,0,1,0,20,20
Maire,0,1,0,8592,8592
Mairi,0,1,0,41,41
Mairit,0,1,0,42,42
Maisa,0,1,0,1611,1611
Maisi,0,1,0,11,11
Maisie,0,1,0,12,12
Maissi,0,1,0,51,51
Maisu,0,1,0,12,12
Maivor,0,1,0,12,12
Maj,0,1,0,693,693
Maja,0,1,0,391,391
Maja-Lisa,0,1,0,22,22
Maj-Brit,0,1,0,37,37
Majbritt,0,1,0,37,37
Maj-Britt,0,1,0,1275,1275
Majed,1,0,15,0,15
Majgret,0,1,0,11,11
Maj-Gret,0,1,0,138,138
Maj-Gun,0,1,0,28,28
Maj-Helen,0,1,0,16,16
Majid,1,0,30,0,30
Majken,0,1,0,25,25
Maj-Leena,0,1,0,15,15
Majlen,0,1,0,40,40
Maj-Len,0,1,0,393,393
Majlis,0,1,0,279,279
Maj-Lis,0,1,0,946,946
Maj-Louise,0,1,0,11,11
Maj-Viol,0,1,0,12,12
Majvor,0,1,0,129,129
Make,1,0,15,0,15
Makreeta,0,1,0,13,13
Maks,1,0,18,0,18
Maksim,1,0,227,0,227
Maksimilian,1,0,17,0,17
Maksimus,1,0,31,0,31
Malaika,0,1,0,32,32
Malak,0,1,0,45,45
Malakias,1,0,158,0,158
Malcolm,1,0,45,0,45
Maleena,0,1,0,73,73
Malek,1,0,19,0,19
Malena,0,1,0,227,227
Malene,0,1,0,11,11
Malgorzata,0,1,0,34,34
Mali,0,1,0,10,10
Malia,0,1,0,10,10
Maliina,0,1,0,23,23
Malik,1,0,71,0,71
Malika,0,1,0,38,38
Malin,0,1,0,1167,1167
Malina,0,1,0,29,29
Malla,0,1,0,616,616
Malle,0,1,0,21,21
Mallu,0,1,0,13,13
Malou,0,1,0,40,40
Malte,1,0,72,0,72
Maltti,1,0,10,0,10
Malva,0,1,0,125,125
Malviina,0,1,0,273,273
Malvina,0,1,0,61,61
Mamadou,1,0,10,0,10
Mamdouh,1,0,10,0,10
Man,0.432432432432432,0.567567567567568,16,21,37
Manal,0,1,0,15,15
Manar,0,1,0,14,14
Manasse,1,0,32,0,32
Manda,0,1,0,104,104
Mandana,0,1,0,18,18
Mandi,0,1,0,391,391
Mandy,0,1,0,35,35
Manfred,1,0,72,0,72
Manh,1,0,24,0,24
Manja,0,1,0,58,58
Manna,0,1,0,81,81
Manne,1,0,306,0,306
Mano,1,0,18,0,18
Manolis,1,0,10,0,10
Manon,0,1,0,10,10
Måns,1,0,137,0,137
Mansi,0,1,0,13,13
Mansikka,0,1,0,19,19
Mansour,1,0,18,0,18
Mansur,1,0,12,0,12
Manta,0,1,0,197,197
Manteli,0,1,0,37,37
Manu,1,0,1743,0,1743
Manuel,1,0,647,0,647
Manuela,0,1,0,116,116
Manunpoika,1,0,12,0,12
Mar,0,1,0,19,19
Mara,0.541666666666667,0.458333333333333,13,11,24
Marat,1,0,11,0,11
Marc,1,0,225,0,225
Marcel,1,0,110,0,110
Marcela,0,1,0,32,32
Marcella,0,1,0,45,45
Marcelle,0,1,0,17,17
Marcello,1,0,19,0,19
Marcelo,1,0,24,0,24
Marcia,0,1,0,10,10
Marcin,1,0,14,0,14
Marco,1,0,937,0,937
Marcos,1,0,79,0,79
Marcus,1,0,2404,0,2404
Marcusdotter,0,1,0,13,13
Mare,0,1,0,47,47
Maree,0,1,0,20,20
Mareena,0,1,0,124,124
Marek,1,0,123,0,123
Marella,0,1,0,32,32
Maren,0,1,0,68,68
Marena,0,1,0,86,86
Maret,0,1,0,83,83
Maretta,0,1,0,26,26
Marfa,0,1,0,15,15
Marga,0,1,0,18,18
Margalit,0,1,0,14,14
Margareeta,0,1,0,892,892
Margareetta,0,1,0,961,961
Margaret,0,1,0,451,451
Margareta,0,1,0,11596,11596
Margarete,0,1,0,59,59
Margareth,0,1,0,95,95
Margaretha,0,1,0,2236,2236
Margarethe,0,1,0,80,80
Margaretta,0,1,0,40,40
Margarita,0,1,0,342,342
Marge,0,1,0,41,41
Margerita,0,1,0,16,16
Marget,0,1,0,45,45
Margeta,0,1,0,12,12
Margetta,0,1,0,326,326
Margherita,0,1,0,35,35
Marghita,0,1,0,16,16
Margit,0,1,0,9457,9457
Margita,0,1,0,437,437
Margitha,0,1,0,36,36
Margitta,0,1,0,96,96
Margo,1,0,14,0,14
Margot,0,1,0,238,238
Margret,0,1,0,30,30
Margrete,0,1,0,10,10
Margrethe,0,1,0,15,15
Marguerita,0,1,0,12,12
Marguerite,0,1,0,109,109
Margurite,0,1,0,13,13
Margus,1,0,26,0,26
Mari,0,1,0,24376,24376
Maria,0.000200662185211197,0.999799337814789,40,199300,199340
Mária,0,1,0,27,27
María,0,1,0,56,56
Mariaana,0,1,0,452,452
Maria-Christina,0,1,0,10,10
Maria-Elena,0,1,0,19,19
Maria-Elina,0,1,0,18,18
Maria-Elisa,0,1,0,10,10
Maria-Emilia,0,1,0,12,12
Mariah,0,1,0,41,41
Maria-Helena,0,1,0,40,40
Maria-Johanna,0,1,0,11,11
Maria-Kristiina,0,1,0,13,13
Maria-Leena,0,1,0,174,174
Maria-Liisa,0,1,0,214,214
Mariam,0,1,0,335,335
Mariama,0,1,0,48,48
Marian,0.0346456692913386,0.965354330708661,22,613,635
Mariana,0,1,0,545,545
Mariann,0,1,0,387,387
Mari-Ann,0,1,0,142,142
Marianna,0,1,0,3822,3822
Mari-Anna,0,1,0,138,138
Marianne,0,1,0,21657,21657
Mari-Anne,0,1,0,484,484
Mari-Anneli,0,1,0,20,20
Mari-Anni,0,1,0,13,13
Mari-Annika,0,1,0,30,30
Mari-Annukka,0,1,0,16,16
Mariano,1,0,24,0,24
Mariantytär,0,1,0,15,15
Maria-Pia,0,1,0,10,10
Maria-Riitta,0,1,0,31,31
Maria-Sofia,0,1,0,35,35
Maria-Teresa,0,1,0,18,18
Maria-Terttu,0,1,0,22,22
Mariatta,0,1,0,59,59
Maribel,0,1,0,24,24
Marica,0,1,0,396,396
Marice,0,1,0,13,13
Marida,0,1,0,12,12
Marie,0.0072013093289689,0.992798690671031,44,6066,6110
Marié,0,1,0,19,19
Marie-Ann,0,1,0,10,10
Marie-Anne,0,1,0,17,17
Marie-Charlotte,0,1,0,10,10
Marie-Christine,0,1,0,27,27
Marie-Helene,0,1,0,15,15
Mariel,0,1,0,576,576
Mariela,0,1,0,345,345
Mari-Elina,0,1,0,25,25
Mariell,0,1,0,19,19
Mariella,0,1,0,994,994
Mari-Ella,0,1,0,24,24
Marielle,0,1,0,133,133
Marie-Louise,0,1,0,286,286
Mariem,0,1,0,10,10
Marienna,0,1,0,10,10
Marie-Sofie,0,1,0,17,17
Mariet,0,1,0,27,27
Marietta,0,1,0,275,275
Mariette,0,1,0,167,167
Marigona,0,1,0,15,15
Mari-Hannele,0,1,0,20,20
Mari-Helen,0,1,0,13,13
Mari-Helena,0,1,0,23,23
Marii,0,1,0,16,16
Mariia,0,1,0,1631,1631
Mariija,0,1,0,22,22
Mariika,0,1,0,15,15
Mariikka,0,1,0,55,55
Mariina,0,1,0,280,280
Mariisa,0,1,0,15,15
Mariita,0,1,0,113,113
Mariitta,0,1,0,1445,1445
Marija,0,1,0,178,178
Marijaana,0,1,0,22,22
Mari-Jaana,0,1,0,25,25
Mari-Johanna,0,1,0,59,59
Marika,0,1,0,26532,26532
Mari-Kaarina,0,1,0,11,11
Mari-Kaisa,0,1,0,24,24
Marike,0,1,0,34,34
Marikka,0,1,0,154,154
Marikki,0,1,0,465,465
Mariko,0,1,0,43,43
Marileena,0,1,0,16,16
Mari-Leena,0,1,0,40,40
Mariliina,0,1,0,33,33
Mariliisa,0,1,0,12,12
Mari-Liisa,0,1,0,22,22
Marilin,0,1,0,10,10
Marilla,0,1,0,150,150
Mari-Louise,0,1,0,40,40
Marilyn,0,1,0,50,50
Marina,0,1,0,3831,3831
Marine,0,1,0,58,58
Marinella,0,1,0,75,75
Marinette,0,1,0,11,11
Marinka,0,1,0,162,162
Marinna,0,1,0,13,13
Marino,1,0,21,0,21
Marintytär,0,1,0,13,13
Marinus,1,0,12,0,12
Mario,0.948412698412698,0.0515873015873016,239,13,252
Marion,0,1,0,261,261
Marios,1,0,24,0,24
Maris,0,1,0,18,18
Marisa,0,1,0,309,309
Marisanna,0,1,0,29,29
Mari-Sanna,0,1,0,11,11
Mari-Sisko,0,1,0,12,12
Mariska,0,1,0,21,21
Mari-Sofia,0,1,0,11,11
Marisol,0,1,0,24,24
Marissa,0,1,0,429,429
Mari-Susanna,0,1,0,33,33
Marit,0,1,0,562,562
Märit,0,1,0,11,11
Marita,0,1,0,24205,24205
Maritha,0,1,0,12,12
Maritsa,0,1,0,66,66
Maritta,0,1,0,10379,10379
Mari-Tuulia,0,1,0,13,13
Maritza,0,1,0,106,106
Marius,1,0,672,0,672
Mariwan,1,0,10,0,10
Mariya,0,1,0,19,19
Mariza,0,1,0,45,45
Marja,0,1,0,45750,45750
Marjaana,0,1,0,19667,19667
Marja-Anneli,0,1,0,35,35
Marja-Elina,0,1,0,44,44
Marja-Hannele,0,1,0,16,16
Marja-Helena,0,1,0,112,112
Marja-Kaarina,0,1,0,90,90
Marja-Kaisa,0,1,0,82,82
Marja-Kristiina,0,1,0,40,40
Marjale,0,1,0,27,27
Marja-Lea,0,1,0,36,36
Marjaleena,0,1,0,203,203
Marja-Leena,0,1,0,11867,11867
Marja-Lena,0,1,0,21,21
Marjaliisa,0,1,0,155,155
Marja-Liisa,0,1,0,10874,10874
Marjam,0,1,0,21,21
Marja-Maija,0,1,0,28,28
Marjan,0,1,0,19,19
Marjana,0,1,0,61,61
Marjanna,0,1,0,108,108
Marjanne,0,1,0,412,412
Marja-Reetta,0,1,0,11,11
Marja-Riikka,0,1,0,14,14
Marjariitta,0,1,0,33,33
Marja-Riitta,0,1,0,1381,1381
Marja-Sinikka,0,1,0,12,12
Marja-Sisko,0,1,0,142,142
Marjaterttu,0,1,0,51,51
Marja-Terttu,0,1,0,1716,1716
Marjatta,0,1,0,94045,94045
Marja-Tuulia,0,1,0,10,10
Marja-Tuulikki,0,1,0,18,18
Marje,0,1,0,87,87
Marjeli,0,1,0,24,24
Marjetta,0,1,0,136,136
Marjo,0,1,0,11784,11784
Marjo-Hannele,0,1,0,10,10
Marjo-Helena,0,1,0,10,10
Marjo-Kaisa,0,1,0,30,30
Marjo-Leena,0,1,0,54,54
Marjo-Liisa,0,1,0,70,70
Marjo-Reetta,0,1,0,10,10
Marjorie,0,1,0,52,52
Marjo-Riikka,0,1,0,64,64
Marjoriina,0,1,0,10,10
Marjo-Riina,0,1,0,14,14
Marjoriitta,0,1,0,39,39
Marjo-Riitta,0,1,0,1107,1107
Marjo-Rita,0,1,0,10,10
Marju,0,1,0,664,664
Marjukka,0,1,0,6694,6694
Marjuska,0,1,0,38,38
Marjut,0,1,0,13611,13611
Mark,1,0,619,0,619
Markareeta,0,1,0,18,18
Markareetta,0,1,0,52,52
Marke,0,1,0,295,295
Market,0,1,0,27,27
Marketta,0,1,0,19999,19999
Markit,0,1,0,182,182
Markitta,0,1,0,36,36
Markko,1,0,78,0,78
Markku,1,0,40381,0,40381
Markku-Juhani,1,0,17,0,17
Markku-Pekka,1,0,16,0,16
Markkus,1,0,15,0,15
Marko,1,0,29814,0,29814
Marko-Juhani,1,0,20,0,20
Marko-Mikael,1,0,13,0,13
Markonpoika,1,0,150,0,150
Markontytär,0,1,0,55,55
Marko-Pekka,1,0,12,0,12
Marko-Petteri,1,0,12,0,12
Markos,1,0,50,0,50
Marko-Tapani,1,0,21,0,21
Marko-Tapio,1,0,49,0,49
Markuksenpoika,1,0,63,0,63
Markuksentytär,0,1,0,24,24
Markunpoika,1,0,234,0,234
Markuntytär,0,1,0,49,49
Markus,1,0,43316,0,43316
Markusdotter,0,1,0,11,11
Marla,0,1,0,51,51
Marle,0,1,0,36,36
Marleen,0,1,0,33,33
Marleena,0,1,0,1593,1593
Marleene,0,1,0,32,32
Marlen,0,1,0,118,118
Marlén,0,1,0,41,41
Marlena,0,1,0,126,126
Marlene,0,1,0,921,921
Marléne,0,1,0,75,75
Marley,1,0,14,0,14
Marlo,1,0,101,0,101
Marlon,1,0,96,0,96
Marno,1,0,18,0,18
Marsa,0,1,0,31,31
Marshall,1,0,10,0,10
Mart,1,0,24,0,24
Marta,0,1,0,205,205
Márta,0,1,0,10,10
Märta,0,1,0,568,568
Mårten,1,0,414,0,414
Martha,0,1,0,249,249
Märtha,0,1,0,189,189
Martiina,0,1,0,60,60
Martimo,1,0,12,0,12
Martin,1,0,3650,0,3650
Martina,0,1,0,1384,1384
Martine,0,1,0,36,36
Martino,1,0,16,0,16
Martinpoika,1,0,107,0,107
Martintytär,0,1,0,31,31
Martinus,1,0,17,0,17
Márton,1,0,11,0,11
Martta,0,1,0,7668,7668
Martta-Liisa,0,1,0,11,11
Martti,1,0,26755,0,26755
Marttiina,0,1,0,140,140
Martti-Mikael,1,0,13,0,13
Marttin,1,0,15,0,15
Marttina,0,1,0,12,12
Maru,0,1,0,16,16
Marus,0,1,0,15,15
Marusja,0,1,0,26,26
Maruska,0,1,0,14,14
Marutzella,0,1,0,21,21
Maruzella,0,1,0,20,20
Marvin,1,0,39,0,39
Marwa,0,1,0,54,54
Marwan,1,0,42,0,42
Mary,0,1,0,756,756
Marya,0,1,0,13,13
Maryam,0,1,0,191,191
Maryama,0,1,0,49,49
Maryan,0,1,0,64,64
Maryann,0,1,0,16,16
Mary-Ann,0,1,0,110,110
Maryanne,0,1,0,26,26
Mary-Anne,0,1,0,42,42
Masa,1,0,68,0,68
Masi,1,0,275,0,275
Mason,1,0,16,0,16
Masood,1,0,12,0,12
Masoud,1,0,15,0,15
Massimo,1,0,33,0,33
Master,1,0,12,0,12
Masud,1,0,15,0,15
Mataleena,0,1,0,84,84
Mateo,1,0,65,0,65
Mateus,1,0,38,0,38
Mateusz,1,0,10,0,10
Mathea,0,1,0,11,11
Matheo,1,0,65,0,65
Matheus,1,0,21,0,21
Mathew,1,0,24,0,24
Mathias,1,0,2369,0,2369
Mathieu,1,0,16,0,16
Mathilda,0,1,0,1037,1037
Mathilde,0,1,0,96,96
Matias,1,0,62520,0,62520
Matilda,0,1,0,18462,18462
Matilde,0,1,0,66,66
Matinpoika,1,0,519,0,519
Matintytär,0,1,0,163,163
Matja,0,1,0,13,13
Matleena,0,1,0,3321,3321
Matlena,0,1,0,40,40
Matroona,0,1,0,13,13
Mats,1,0,2021,0,2021
Matsdotter,0,1,0,21,21
Mats-Erik,1,0,36,0,36
Mats-Johan,1,0,17,0,17
Matsson,1,0,13,0,13
Matt,1,0,20,0,20
Matte,1,0,10,0,10
Matteo,1,0,152,0,152
Matteus,1,0,334,0,334
Matthew,1,0,323,0,323
Matthias,1,0,221,0,221
Matthieu,1,0,13,0,13
Matti,1,0,84252,0,84252
Mattia,1,0,26,0,26
Mattias,1,0,2195,0,2195
Matti-Esko,1,0,12,0,12
Mattiina,0,1,0,10,10
Matti-Juhani,1,0,48,0,48
Matti-Jussi,1,0,20,0,20
Matti-Mikael,1,0,23,0,23
Matti-Oskari,1,0,14,0,14
Matti-Pekka,1,0,144,0,144
Matti-Petteri,1,0,28,0,28
Mattis,1,0,31,0,31
Matti-Tapio,1,0,11,0,11
Matti-Veikko,1,0,12,0,12
Matts,1,0,573,0,573
Matts-Erik,1,0,24,0,24
Mattus,1,0,15,0,15
Matvei,1,0,55,0,55
Matvey,1,0,18,0,18
Maud,0,1,0,132,132
Mauno,1,0,5728,0,5728
Maunonpoika,1,0,10,0,10
Maunu,1,0,477,0,477
Maunus,1,0,11,0,11
Maura,0,1,0,102,102
Maureen,0,1,0,16,16
Mauri,1,0,10156,0,10156
Maurice,1,0,52,0,52
Mauricio,1,0,28,0,28
Maurinpoika,1,0,42,0,42
Maurintytär,0,1,0,21,21
Maurita,0,1,0,11,11
Maurits,1,0,328,0,328
Mauritz,1,0,719,0,719
Mauriz,1,0,46,0,46
Maurizio,1,0,12,0,12
Mauro,1,0,35,0,35
Max,1,0,4147,0,4147
Maxi,1,0,16,0,16
Maxim,1,0,357,0,357
Maxima,0,1,0,14,14
Maxime,1,0,42,0,42
Maximiliam,1,0,16,0,16
Maximilian,1,0,715,0,715
Maximilien,1,0,10,0,10
Maximillian,1,0,52,0,52
Maximo,1,0,16,0,16
Maximus,1,0,316,0,316
Maxine,0,1,0,45,45
Maxwell,1,0,60,0,60
May,0,1,0,426,426
Maya,0,1,0,644,644
May-Britt,0,1,0,60,60
May-Gret,0,1,0,12,12
May-Len,0,1,0,25,25
Mayvor,0,1,0,29,29
Md,1,0,65,0,65
Md.,1,0,72,0,72
Mea,0,1,0,1118,1118
Mea-Maria,0,1,0,20,20
Medina,0,1,0,48,48
Meea,0,1,0,657,657
Meela,0,1,0,13,13
Meeli,0,1,0,11,11
Meelis,1,0,16,0,16
Meemi,0,1,0,20,20
Meena,0,1,0,33,33
Meeri,0,1,0,4955,4955
Meerika,0,1,0,12,12
Meeri-Maria,0,1,0,11,11
Meerit,0,1,0,65,65
Meg,0,1,0,14,14
Megan,0,1,0,52,52
Meh,0,1,0,41,41
Mehdi,1,0,85,0,85
Mehmet,1,0,178,0,178
Mehran,1,0,13,0,13
Mei,0,1,0,163,163
Meija,0,1,0,74,74
Meiju,0,1,0,468,468
Meimi,0,1,0,253,253
Meini,0,1,0,23,23
Meir,1,0,12,0,12
Meira,0,1,0,93,93
Meja,0,1,0,76,76
Melani,0,1,0,11,11
Melania,0,1,0,12,12
Melanie,0,1,0,240,240
Mélanie,0,1,0,16,16
Melchior,1,0,14,0,14
Melek,0,1,0,74,74
Meli,0,1,0,13,13
Melia,0,1,0,36,36
Melian,0,1,0,19,19
Melica,0,1,0,14,14
Melida,0,1,0,38,38
Meliha,0,1,0,16,16
Meliida,0,1,0,11,11
Meliina,0,1,0,79,79
Meliisa,0,1,0,13,13
Melik,1,0,12,0,12
Melika,0,1,0,22,22
Melike,0,1,0,36,36
Melina,0,1,0,1734,1734
Melinda,0,1,0,691,691
Melis,0,1,0,45,45
Melisa,0,1,0,306,306
Melise,0,1,0,29,29
Melissa,0,1,0,1861,1861
Melisse,0,1,0,13,13
Melita,0,1,0,70,70
Melitta,0,1,0,13,13
Melker,1,0,101,0,101
Mella,0,1,0,66,66
Melodi,0,1,0,15,15
Melodia,0,1,0,29,29
Melody,0,1,0,68,68
Melvin,1,0,208,0,208
Melwin,1,0,57,0,57
Mena,0,1,0,13,13
Menna,0,1,0,55,55
Menni,0,1,0,108,108
Mentor,1,0,13,0,13
Meo,1,0,16,0,16
Meral,0,1,0,12,12
Mercedes,0,1,0,199,199
Meredith,0,1,0,12,12
Merelle,0,1,0,13,13
Merena,0,1,0,15,15
Mereta,0,1,0,24,24
Merete,0,1,0,104,104
Merethe,0,1,0,14,14
Merette,0,1,0,40,40
Mergim,1,0,27,0,27
Meri,0,1,0,4761,4761
Meria,0,1,0,17,17
Meriam,0,1,0,20,20
Merianna,0,1,0,18,18
Meri-Anna,0,1,0,11,11
Meriel,0,1,0,25,25
Meriella,0,1,0,12,12
Meriem,0,1,0,27,27
Merihelmi,0,1,0,28,28
Meri-Helmi,0,1,0,34,34
Meriina,0,1,0,13,13
Meriitta,0,1,0,19,19
Merika,0,1,0,148,148
Merike,0,1,0,179,179
Merikki,0,1,0,21,21
Merikukka,0,1,0,33,33
Meri-Kukka,0,1,0,20,20
Merili,0,1,0,17,17
Merilin,0,1,0,21,21
Merilla,0,1,0,30,30
Merima,0,1,0,10,10
Meri-Maaria,0,1,0,20,20
Meri-Maija,0,1,0,10,10
Merina,0,1,0,79,79
Merisa,0,1,0,10,10
Meri-Sisko,0,1,0,10,10
Merissa,0,1,0,11,11
Merit,0,1,0,91,91
Merita,0,1,0,716,716
Meritta,0,1,0,67,67
Merituuli,0,1,0,338,338
Meri-Tuuli,0,1,0,389,389
Merituulia,0,1,0,67,67
Meri-Tuulia,0,1,0,225,225
Meri-Tuulikki,0,1,0,11,11
Merja,0,1,0,21251,21251
Merja-Anneli,0,1,0,10,10
Merja-Hannele,0,1,0,15,15
Merja-Helena,0,1,0,12,12
Merja-Leena,0,1,0,86,86
Merja-Liisa,0,1,0,235,235
Merja-Riitta,0,1,0,115,115
Merja-Terttu,0,1,0,13,13
Merjem,0,1,0,10,10
Merle,0,1,0,48,48
Merliina,0,1,0,11,11
Merlin,1,0,27,0,27
Merri,1,0,13,0,13
Mert,1,0,58,0,58
Mertsi,1,0,419,0,419
Mertta,0,1,0,38,38
Mertzi,1,0,17,0,17
Merva,0,1,0,17,17
Merve,0,1,0,34,34
Mervi,0,1,0,9899,9899
Mery,0,1,0,10,10
Meryam,0,1,0,10,10
Meryem,0,1,0,61,61
Mesi,0,1,0,48,48
Mesimarja,0,1,0,16,16
Mesut,1,0,14,0,14
Meta,0,1,0,20,20
Mete,1,0,20,0,20
Metin,1,0,34,0,34
Metsätähti,0,1,0,26,26
Metta,0,1,0,46,46
Mette,0,1,0,1485,1485
Mette-Maaria,0,1,0,12,12
Mette-Maarit,0,1,0,14,14
Mette-Maria,0,1,0,36,36
Metti,0,1,0,42,42
Meya,0,1,0,27,27
Mi,0,1,0,64,64
Mia,0,1,0,7726,7726
Mia-Liisa,0,1,0,11,11
Mia-Maarit,0,1,0,15,15
Mia-Maija,0,1,0,13,13
Mia-Mari,0,1,0,42,42
Mia-Maria,0,1,0,163,163
Mia-Marika,0,1,0,27,27
Miana,0,1,0,13,13
Mianna,0,1,0,92,92
Mia-Riikka,0,1,0,11,11
Mia-Riitta,0,1,0,18,18
Mia-Sofia,0,1,0,16,16
Mica,1,0,29,0,29
Micael,1,0,590,0,590
Micaela,0,1,0,807,807
Micah,1,0,26,0,26
Michael,0.997457822972036,0.00254217702796395,4316,11,4327
Michaela,0,1,0,1010,1010
Michail,1,0,27,0,27
Michal,0.681818181818182,0.318181818181818,30,14,44
Michel,1,0,228,0,228
Michela,0,1,0,28,28
Michele,0.505882352941176,0.494117647058824,43,42,85
Michell,0,1,0,12,12
Michella,0,1,0,11,11
Michelle,0,1,0,725,725
Mici,1,0,60,0,60
Mick,1,0,24,0,24
Mickael,1,0,82,0,82
Micke,1,0,176,0,176
Mickel,1,0,25,0,25
Mickey,1,0,19,0,19
Micky,1,0,20,0,20
Miclas,1,0,10,0,10
Mico,1,0,1211,0,1211
Mielikki,0,1,0,387,387
Mielo,0,1,0,16,16
Mies,1,0,107,0,107
Migael,1,0,12,0,12
Miguel,1,0,200,0,200
Mihael,1,0,22,0,22
Mihaela,0,1,0,18,18
Mihai,1,0,15,0,15
Mihail,1,0,267,0,267
Mihailovna,0,1,0,23,23
Mihhail,1,0,14,0,14
Mihka,1,0,10,0,10
Mihkal,1,0,12,0,12
Mihkel,1,0,21,0,21
Mihku,1,0,15,0,15
Mii,0,1,0,18,18
Miia,0,1,0,9603,9603
Miia-Johanna,0,1,0,10,10
Miia-Leena,0,1,0,11,11
Miia-Liisa,0,1,0,27,27
Miia-Maaria,0,1,0,23,23
Miia-Maarit,0,1,0,21,21
Miia-Mari,0,1,0,60,60
Miia-Maria,0,1,0,155,155
Miia-Marika,0,1,0,41,41
Miia-Riikka,0,1,0,27,27
Miia-Riina,0,1,0,11,11
Miida,0,1,0,69,69
Miihkali,1,0,68,0,68
Miija,0,1,0,39,39
Miika,1,0,8671,0,8671
Miikael,1,0,683,0,683
Miika-Markus,1,0,14,0,14
Miika-Matias,1,0,23,0,23
Miika-Matti,1,0,11,0,11
Miikanpoika,1,0,33,0,33
Miikantytär,0,1,0,19,19
Miika-Petteri,1,0,11,0,11
Miikka,1,0,5022,0,5022
Miikkael,1,0,792,0,792
Miikka-Matias,1,0,11,0,11
Miiko,1,0,181,0,181
Miiku,1,0,15,0,15
Miila,0,1,0,282,282
Miili,0,1,0,79,79
Miilia,0,1,0,57,57
Miilo,1,0,23,0,23
Miima,0,1,0,10,10
Miimi,0,1,0,11,11
Miina,0,1,0,1627,1627
Miina-Liisa,0,1,0,10,10
Miina-Maria,0,1,0,28,28
Miinu,0,1,0,18,18
Miio,1,0,216,0,216
Miira,0,1,0,359,359
Miiro,1,0,165,0,165
Miisa,0,1,0,1366,1366
Miisa-Maria,0,1,0,20,20
Miita,0,1,0,17,17
Miitrei,1,0,13,0,13
Miitri,1,0,48,0,48
Miitta,0,1,0,145,145
Miitu,0,1,0,20,20
Miiu,0,1,0,20,20
Mija,0,1,0,16,16
Mika,0.99972826825358,0.000271731746419934,36791,10,36801
Mika-Antti,1,0,10,0,10
Mikaeela,0,1,0,15,15
Mikael,0.999890964960103,0.000109035039896912,100874,11,100885
Mikaël,1,0,18,0,18
Mikaela,0,1,0,5948,5948
Mikaeli,1,0,99,0,99
Mikaelinpoika,1,0,12,0,12
Mikaella,0,1,0,17,17
Mikaelsdotter,0,1,0,43,43
Mikaelsson,1,0,21,0,21
Mika-Erik,1,0,12,0,12
Mikail,1,0,100,0,100
Mika-Juhani,1,0,18,0,18
Mika-Kristian,1,0,10,0,10
Mika-Markus,1,0,15,0,15
Mika-Matias,1,0,10,0,10
Mika-Matti,1,0,74,0,74
Mikanpoika,1,0,221,0,221
Mikantytär,0,1,0,79,79
Mika-Pekka,1,0,66,0,66
Mika-Petri,1,0,79,0,79
Mika-Petteri,1,0,85,0,85
Mika-Tapani,1,0,11,0,11
Mika-Tapio,1,0,11,0,11
Mike,1,0,230,0,230
Mikel,1,0,21,0,21
Mikhael,1,0,17,0,17
Mikhail,1,0,170,0,170
Miki,1,0,531,0,531
Mikka,1,0,12,0,12
Mikkal,1,0,10,0,10
Mikke,1,0,386,0,386
Mikkel,1,0,45,0,45
Mikkeli,1,0,11,0,11
Mikki,1,0,111,0,111
Mikko,1,0,46173,0,46173
Mikko-Juhani,1,0,24,0,24
Mikko-Jussi,1,0,10,0,10
Mikko-Matias,1,0,40,0,40
Mikko-Matti,1,0,40,0,40
Mikko-Oskari,1,0,18,0,18
Mikko-Pekka,1,0,125,0,125
Mikko-Petteri,1,0,59,0,59
Mikko-Samuli,1,0,10,0,10
Mikko-Tapio,1,0,11,0,11
Mikko-Ville,1,0,37,0,37
Miklas,1,0,149,0,149
Miklos,1,0,44,0,44
Miko,1,0,2812,0,2812
Mikolas,1,0,12,0,12
Miko-Matias,1,0,11,0,11
Mikonpoika,1,0,435,0,435
Mikontytär,0,1,0,119,119
Miku,1,0,131,0,131
Mila,0,1,0,2176,2176
Milad,1,0,32,0,32
Milada,0,1,0,14,14
Milaja,0,1,0,173,173
Mila-Maria,0,1,0,11,11
Milan,1,0,141,0,141
Milana,0,1,0,454,454
Milaya,0,1,0,16,16
Milda,0,1,0,137,137
Mildred,0,1,0,89,89
Mildrid,0,1,0,62,62
Milea,0,1,0,41,41
Mileena,0,1,0,13,13
Milena,0,1,0,821,821
Miles,1,0,31,0,31
Milga,0,1,0,16,16
Mili,0,1,0,52,52
Milia,0,1,0,48,48
Miliam,1,0,10,0,10
Milian,1,0,30,0,30
Miliana,0,1,0,13,13
Milica,0,1,0,12,12
Milina,0,1,0,17,17
Militsa,0,1,0,24,24
Militza,0,1,0,14,14
Miliza,0,1,0,15,15
Milja,0,1,0,5430,5430
Miljaana,0,1,0,61,61
Milja-Emilia,0,1,0,11,11
Milja-Maaria,0,1,0,18,18
Milja-Maria,0,1,0,43,43
Milka,0,1,0,1026,1026
Milka-Maria,0,1,0,11,11
Milko,1,0,119,0,119
Milla,0,1,0,9746,9746
Milla-Emilia,0,1,0,26,26
Milla-Maaria,0,1,0,63,63
Milla-Maarit,0,1,0,15,15
Millamari,0,1,0,20,20
Milla-Mari,0,1,0,62,62
Millamaria,0,1,0,17,17
Milla-Maria,0,1,0,150,150
Milla-Riikka,0,1,0,12,12
Milla-Riina,0,1,0,29,29
Milla-Riitta,0,1,0,10,10
Milla-Roosa,0,1,0,10,10
Milli,0,1,0,89,89
Millie,0,1,0,26,26
Milly,0,1,0,13,13
Milma,0,1,0,199,199
Milo,1,0,1031,0,1031
Milona,0,1,0,16,16
Milos,1,0,31,0,31
Milou,0,1,0,17,17
Milton,1,0,224,0,224
Milva,0,1,0,11,11
Milvi,0,1,0,18,18
Mimi,0,1,0,174,174
Mimma,0,1,0,31,31
Mimmi,0,1,0,946,946
Mimmu,0,1,0,54,54
Mimosa,0,1,0,1801,1801
Mimoza,0,1,0,24,24
Min,0.473684210526316,0.526315789473684,18,20,38
Mina,0,1,0,161,161
Minca,0,1,0,11,11
Minda,0,1,0,85,85
Mindi,0,1,0,59,59
Mindy,0,1,0,45,45
Mine,0,1,0,14,14
Minea,0,1,0,3138,3138
Minéa,0,1,0,52,52
Minella,0,1,0,77,77
Minerva,0,1,0,715,715
Minessa,0,1,0,61,61
Minetta,0,1,0,19,19
Minette,0,1,0,76,76
Ming,0.6,0.4,30,20,50
Minh,0.731517509727626,0.268482490272374,188,69,257
Minja,0,1,0,1740,1740
Minja-Maria,0,1,0,10,10
Minka,0,1,0,679,679
Minna,0,1,0,29765,29765
Minna-Elina,0,1,0,13,13
Minna-Helena,0,1,0,11,11
Minna-Johanna,0,1,0,13,13
Minna-Kaarina,0,1,0,17,17
Minnakaisa,0,1,0,10,10
Minna-Kaisa,0,1,0,78,78
Minna-Kristiina,0,1,0,26,26
Minnaleena,0,1,0,11,11
Minna-Leena,0,1,0,88,88
Minnaliisa,0,1,0,35,35
Minna-Liisa,0,1,0,362,362
Minna-Maaria,0,1,0,62,62
Minna-Maarit,0,1,0,89,89
Minnamaija,0,1,0,11,11
Minna-Maija,0,1,0,56,56
Minnamari,0,1,0,92,92
Minna-Mari,0,1,0,208,208
Minnamaria,0,1,0,23,23
Minna-Maria,0,1,0,251,251
Minna-Marika,0,1,0,27,27
Minna-Marja,0,1,0,22,22
Minna-Marjaana,0,1,0,14,14
Minnami,0,1,0,14,14
Minna-Riikka,0,1,0,43,43
Minna-Riitta,0,1,0,86,86
Minna-Sisko,0,1,0,18,18
Minna-Susanna,0,1,0,13,13
Minne,0,1,0,44,44
Minnea,0,1,0,235,235
Minni,0,1,0,688,688
Minnie,0,1,0,38,38
Minni-Maria,0,1,0,10,10
Mino,1,0,48,0,48
Minta,0,1,0,35,35
Minttu,0,1,0,4212,4212
Minttumaaria,0,1,0,17,17
Minttu-Maaria,0,1,0,90,90
Minttu-Mari,0,1,0,16,16
Minttu-Maria,0,1,0,85,85
Mio,1,0,600,0,600
Miona,0,1,0,65,65
Mir,1,0,16,0,16
Mira,0,1,0,7639,7639
Mirabella,0,1,0,44,44
Mirabelle,0,1,0,11,11
Miralda,0,1,0,10,10
Mira-Maria,0,1,0,42,42
Miran,1,0,25,0,25
Mirana,0,1,0,16,16
Miranda,0,1,0,1060,1060
Miranna,0,1,0,85,85
Mirca,0,1,0,15,15
Mirco,1,0,26,0,26
Mire,0,1,0,10,10
Mireia,0,1,0,10,10
Mireille,0,1,0,34,34
Mireka,0,1,0,15,15
Mirel,0,1,0,10,10
Mirela,0,1,0,30,30
Mirella,0,1,0,1635,1635
Mirelle,0,1,0,103,103
Mirena,0,1,0,12,12
Miretta,0,1,0,32,32
Mirette,0,1,0,152,152
Miri,0,1,0,13,13
Miria,0,1,0,15,15
Miriam,0,1,0,847,847
Mirigli,0,1,0,31,31
Mirika,0,1,0,11,11
Mirikli,0,1,0,115,115
Mirina,0,1,0,13,13
Mirita,0,1,0,10,10
Miritza,0,1,0,11,11
Mirja,0,1,0,16288,16288
Mirjaana,0,1,0,24,24
Mirja-Kaarina,0,1,0,13,13
Mirja-Leena,0,1,0,112,112
Mirjaliisa,0,1,0,14,14
Mirja-Liisa,0,1,0,386,386
Mirjam,0,1,0,11490,11490
Mirja-Maija,0,1,0,18,18
Mirjami,0,1,0,16965,16965
Mirjana,0,1,0,14,14
Mirja-Riitta,0,1,0,40,40
Mirka,0.0138888888888889,0.986111111111111,35,2485,2520
Mirka-Maria,0,1,0,16,16
Mirke,0,1,0,11,11
Mirkka,0,1,0,741,741
Mirkku,0,1,0,79,79
Mirko,1,0,545,0,545
Mirna,0,1,0,13,13
Miro,1,0,5830,0,5830
Miro-Matias,1,0,19,0,19
Miron,1,0,41,0,41
Miro-Petteri,1,0,11,0,11
Miroslav,1,0,33,0,33
Mirsad,1,0,12,0,12
Mirta,0,1,0,11,11
Mirva,0,1,0,3220,3220
Mirva-Liisa,0,1,0,21,21
Mirve,0,1,0,18,18
Miryam,0,1,0,13,13
Mirza,1,0,23,0,23
Misa,0.704433497536946,0.295566502463054,143,60,203
Misael,1,0,62,0,62
Misca,1,0,35,0,35
Mischa,1,0,20,0,20
Misella,0,1,0,16,16
Miselle,0,1,0,10,10
Misha,1,0,38,0,38
Mishka,1,0,15,0,15
Miska,0.987555555555556,0.0124444444444444,3333,42,3375
Miski,0,1,0,12,12
Miso,1,0,55,0,55
Mitchell,1,0,20,0,20
Mitja,0.953216374269006,0.0467836257309941,326,16,342
Mitjo,1,0,12,0,12
Mitra,0,1,0,81,81
Mitri,1,0,40,0,40
Mitro,1,0,176,0,176
Miya,0,1,0,13,13
Moa,0,1,0,378,378
Moalim,1,0,11,0,11
Modou,1,0,13,0,13
Moe,0,1,0,14,14
Mohamad,0.891089108910891,0.108910891089109,90,11,101
Mohamed,0.717023675310034,0.282976324689966,1908,753,2661
Mohammad,0.938428874734607,0.0615711252653928,442,29,471
Mohammed,0.825,0.175,462,98,560
Mohamoud,0.542857142857143,0.457142857142857,19,16,35
Mohamud,0.622282608695652,0.377717391304348,229,139,368
Mohamuud,0,1,0,10,10
Mohan,1,0,13,0,13
Mohsen,1,0,32,0,32
Moira,0,1,0,25,25
Mokhtar,1,0,12,0,12
Molla,0,1,0,33,33
Mollie,0,1,0,11,11
Molly,0,1,0,177,177
Momodou,1,0,15,0,15
Mona,0,1,0,2374,2374
Mona-Liisa,0,1,0,11,11
Monalisa,0,1,0,11,11
Mona-Lisa,0,1,0,86,86
Mona-Maria,0,1,0,25,25
Monia,0,1,0,19,19
Monica,0,1,0,2935,2935
Monika,0,1,0,1882,1882
Monique,0,1,0,43,43
Monja,0,1,0,13,13
Monna,0,1,0,113,113
Moona,0,1,0,1654,1654
Moona-Maria,0,1,0,11,11
Moonika,0,1,0,142,142
Mooses,1,0,107,0,107
Morad,1,0,15,0,15
Morgan,0.879194630872483,0.120805369127517,131,18,149
Morits,1,0,10,0,10
Moritz,1,0,123,0,123
Morris,1,0,175,0,175
Morten,1,0,33,0,33
Mortimer,1,0,45,0,45
Mortti,1,0,44,0,44
Moses,1,0,40,0,40
Moshe,1,0,11,0,11
Mostafa,1,0,55,0,55
Mounir,1,0,16,0,16
Mourad,1,0,17,0,17
Moussa,1,0,12,0,12
Moustafa,1,0,15,0,15
Mowlid,1,0,12,0,12
Mubarak,1,0,29,0,29
Mubashir,1,0,12,0,12
Muhamad,1,0,19,0,19
Muhamed,0.849462365591398,0.150537634408602,79,14,93
Muhammad,1,0,240,0,240
Muhammed,1,0,123,0,123
Muhannad,1,0,11,0,11
Muharrem,1,0,15,0,15
Muhiadin,0.52,0.48,13,12,25
Muhsin,1,0,18,0,18
Muhumed,0.444444444444444,0.555555555555556,12,15,27
Mui,0,1,0,12,12
Muisto,0.518134715025907,0.481865284974093,100,93,193
Mukhtar,0.6,0.4,21,14,35
Mulki,0,1,0,12,12
Mumin,0.6,0.4,24,16,40
Muna,0,1,0,26,26
Muniira,0,1,0,15,15
Munir,1,0,16,0,16
Munira,0,1,0,23,23
Murad,1,0,22,0,22
Murat,1,0,68,0,68
Muriel,0,1,0,15,15
Mursal,0.62962962962963,0.37037037037037,17,10,27
Muru,0,1,0,42,42
Musa,1,0,77,0,77
Musab,1,0,24,0,24
Muscab,1,0,12,0,12
Muse,0.558823529411765,0.441176470588235,19,15,34
Mushtak,0,1,0,10,10
Muska,0,1,0,24,24
Muslim,1,0,21,0,21
Musse,0.632352941176471,0.367647058823529,43,25,68
Mustaf,1,0,20,0,20
Mustafa,0.904593639575972,0.0954063604240283,256,27,283
Mustafe,1,0,32,0,32
Mustapha,1,0,60,0,60
Mustikka,0,1,0,22,22
Muthoni,0,1,0,10,10
Muusa,0,1,0,62,62
Muuse,1,0,14,0,14
Muzaffer,1,0,10,0,10
My,0,1,0,430,430
Mya,0,1,0,17,17
Myra,0,1,0,19,19
Myriam,0,1,0,26,26
Myrna,0,1,0,24,24
Myrsky,0.912844036697248,0.0871559633027523,199,19,218
Myrtel,0,1,0,12,12
Myrtle,0,1,0,10,10
Mysi,0,1,0,21,21
Myy,0,1,0,187,187
Naana,0,1,0,22,22
Nabeel,1,0,12,0,12
Nabi,1,0,10,0,10
Nabil,1,0,79,0,79
Nabila,0,1,0,22,22
Nada,0,1,0,84,84
Nadeem,1,0,10,0,10
Nadejda,0,1,0,94,94
Nader,1,0,28,0,28
Nadeschda,0,1,0,24,24
Nadezda,0,1,0,176,176
Nadezhda,0,1,0,37,37
Nadia,0,1,0,262,262
Nadim,1,0,12,0,12
Nadina,0,1,0,12,12
Nadine,0,1,0,122,122
Nadir,1,0,25,0,25
Nadira,0,1,0,14,14
Nadiya,0,1,0,15,15
Nadja,0,1,0,914,914
Nadya,0,1,0,20,20
Nael,1,0,12,0,12
Naema,0,1,0,18,18
Naemi,0,1,0,36,36
Nafisa,0,1,0,16,16
Nahid,0,1,0,20,20
Nahuel,1,0,13,0,13
Naim,1,0,21,0,21
Naima,0,1,0,57,57
Naimi,0,1,0,68,68
Naimo,0,1,0,13,13
Najib,1,0,18,0,18
Najim,1,0,11,0,11
Najma,0,1,0,49,49
Najmo,0,1,0,27,27
Nala,0,1,0,11,11
Nalle,1,0,48,0,48
Nam,1,0,45,0,45
Namir,1,0,11,0,11
Nan,0,1,0,38,38
Nana,0.0604651162790698,0.93953488372093,26,404,430
Nancy,0,1,0,258,258
Nanda,0,1,0,11,11
Nando,1,0,23,0,23
Nandor,1,0,13,0,13
Nanette,0,1,0,119,119
Nani,0,1,0,24,24
Nanja,0,1,0,24,24
Nanna,0,1,0,946,946
Nanne,0,1,0,100,100
Nanni,0,1,0,212,212
Nanny,0,1,0,124,124
Nante,1,0,11,0,11
Naomi,0,1,0,279,279
Napoleon,1,0,35,0,35
Narges,0,1,0,19,19
Narin,0,1,0,19,19
Naser,1,0,28,0,28
Nasim,1,0,27,0,27
Nasir,1,0,46,0,46
Nasra,0,1,0,38,38
Nasrin,0,1,0,33,33
Nasro,0,1,0,26,26
Nasser,1,0,22,0,22
Nasteeho,0,1,0,10,10
Nasteho,0,1,0,16,16
Nasti,0,1,0,52,52
Nata,0,1,0,21,21
Natacha,0,1,0,33,33
Natali,0,1,0,83,83
Natalia,0,1,0,2539,2539
Natalie,0,1,0,963,963
Nataliina,0,1,0,12,12
Natalija,0,1,0,29,29
Nataliya,0,1,0,21,21
Natalja,0,1,0,107,107
Nataly,0,1,0,11,11
Natalya,0,1,0,18,18
Natan,1,0,20,0,20
Natanael,1,0,113,0,113
Nataniel,1,0,18,0,18
Natasa,0,1,0,30,30
Natascha,0,1,0,43,43
Natasha,0,1,0,304,304
Natasia,0,1,0,31,31
Natasja,0,1,0,22,22
Nathali,0,1,0,11,11
Nathalia,0,1,0,61,61
Nathalie,0,1,0,687,687
Nathan,1,0,159,0,159
Nathanael,1,0,49,0,49
Nathaniel,1,0,108,0,108
Natja,0,1,0,37,37
Natta,0,1,0,17,17
Navid,1,0,11,0,11
Nawaal,0,1,0,12,12
Nawal,0,1,0,23,23
Naz,0,1,0,17,17
Nazanin,0,1,0,11,11
Nazar,1,0,14,0,14
Nazir,1,0,12,0,12
Nea,0,1,0,7080,7080
Néa,0,1,0,26,26
Nea-Emilia,0,1,0,18,18
Neah,0,1,0,13,13
Nea-Mari,0,1,0,11,11
Nea-Maria,0,1,0,75,75
Nea-Noora,0,1,0,22,22
Nea-Sofia,0,1,0,27,27
Neda,0,1,0,30,30
Nedim,1,0,10,0,10
Neea,0,1,0,3121,3121
Neea-Maria,0,1,0,16,16
Neela,0,1,0,791,791
Neele,0,1,0,12,12
Neelia,0,1,0,127,127
Neema,0,1,0,16,16
Neena,0,1,0,32,32
Neera,0,1,0,28,28
Neeta,0,1,0,14,14
Neetta,0,1,0,12,12
Nefeli,0,1,0,11,11
Negin,0,1,0,14,14
Nehemia,1,0,18,0,18
Nehemias,1,0,13,0,13
Neija,0,1,0,21,21
Neil,1,0,36,0,36
Neila,0,1,0,14,14
Neili,0,1,0,13,13
Neilikka,0,1,0,45,45
Neko,1,0,10,0,10
Nela,0,1,0,10,10
Nele,0,1,0,22,22
Neli,0,1,0,11,11
Nelia,0,1,0,45,45
Nella,0,1,0,3220,3220
Nella-Maria,0,1,0,16,16
Nella-Noora,0,1,0,12,12
Nella-Sofia,0,1,0,12,12
Nelle,0,1,0,67,67
Nelli,0,1,0,3855,3855
Nellie,0,1,0,151,151
Nelliina,0,1,0,16,16
Nelli-Maria,0,1,0,23,23
Nellinoora,0,1,0,22,22
Nelli-Noora,0,1,0,51,51
Nelli-Sofia,0,1,0,10,10
Nelly,0,1,0,850,850
Nelma,0,1,0,116,116
Nelmi,0,1,0,16,16
Nelson,1,0,107,0,107
Nemi,0,1,0,62,62
Nemo,1,0,212,0,212
Nena,0,1,0,15,15
Nene,0,1,0,13,13
Nenja,0,1,0,10,10
Nenna,0,1,0,380,380
Nenne,0,1,0,38,38
Neo,1,0,416,0,416
Neonilla,0,1,0,37,37
Nerea,0,1,0,14,14
Neri,0,1,0,15,15
Nerissa,0,1,0,18,18
Nermin,0,1,0,14,14
Nero,1,0,10,0,10
Nesrin,0,1,0,14,14
Nessa,0,1,0,86,86
Nessi,0,1,0,10,10
Nesta,1,0,16,0,16
Nestor,1,0,603,0,603
Nestori,1,0,2561,0,2561
Neta,0,1,0,22,22
Netta,0,1,0,2435,2435
Netta-Maria,0,1,0,12,12
Nette,0,1,0,270,270
Neva,0,1,0,12,12
Neve,0,1,0,61,61
Nevzat,1,0,11,0,11
Nga,0,1,0,43,43
Ngan,0,1,0,29,29
Nghia,1,0,15,0,15
Ngoc,0.232,0.768,58,192,250
Ngozi,0,1,0,15,15
Nguyen,0.413793103448276,0.586206896551724,24,34,58
Nguyet,0,1,0,36,36
Nhan,1,0,12,0,12
Nhat,1,0,27,0,27
Nhi,0,1,0,62,62
Nhu,0.166666666666667,0.833333333333333,10,50,60
Nhung,0,1,0,27,27
Nhut,1,0,19,0,19
Nia,0,1,0,164,164
Nic,1,0,12,0,12
Nica,0,1,0,13,13
Nichlas,1,0,33,0,33
Nicholas,1,0,973,0,973
Nici,1,0,41,0,41
Nick,1,0,86,0,86
Nicke,1,0,58,0,58
Nicklas,1,0,511,0,511
Nickolas,1,0,12,0,12
Nicky,1,0,81,0,81
Niclas,1,0,983,0,983
Nico,1,0,3154,0,3154
Nicodemus,1,0,28,0,28
Nicol,0,1,0,12,12
Nicola,0.115079365079365,0.884920634920635,29,223,252
Nicolai,1,0,109,0,109
Nicolas,1,0,1048,0,1048
Nicolás,1,0,24,0,24
Nicole,0,1,0,821,821
Nicoletta,0,1,0,36,36
Nicolette,0,1,0,32,32
Nicolina,0,1,0,186,186
Nicoline,0,1,0,31,31
Nico-Petteri,1,0,14,0,14
Nida,0,1,0,22,22
Niels,1,0,44,0,44
Nietos,1,0,20,0,20
Nihat,1,0,12,0,12
Nii,1,0,11,0,11
Niia,0,1,0,145,145
Niika,0,1,0,20,20
Niikko,1,0,11,0,11
Niila,1,0,695,0,695
Niilas,1,0,133,0,133
Niiles,1,0,85,0,85
Niillas,1,0,13,0,13
Niilo,1,0,9634,0,9634
Niilonpoika,1,0,19,0,19
Niina,0,1,0,12479,12479
Niina-Kaisa,0,1,0,12,12
Niina-Liisa,0,1,0,11,11
Niina-Maija,0,1,0,10,10
Niina-Mari,0,1,0,23,23
Niina-Maria,0,1,0,71,71
Niina-Riikka,0,1,0,18,18
Niini,0,1,0,71,71
Niitty,0,1,0,10,10
Nika,0,1,0,48,48
Nikanor,1,0,120,0,120
Nike,0,1,0,15,15
Niki,0.955795677799607,0.0442043222003929,973,45,1018
Nikita,0.673913043478261,0.326086956521739,279,135,414
Nikke,1,0,292,0,292
Nikki,0.462686567164179,0.537313432835821,31,36,67
Nikko,1,0,31,0,31
Niklas,1,0,9250,0,9250
Niklasdotter,0,1,0,11,11
Niklaus,1,0,13,0,13
Niko,1,0,18391,0,18391
Nikodeemus,1,0,24,0,24
Nikodemus,1,0,331,0,331
Niko-Joonas,1,0,10,0,10
Niko-Kristian,1,0,11,0,11
Nikola,0.684210526315789,0.315789473684211,52,24,76
Nikolaevna,0,1,0,31,31
Nikolai,1,0,4641,0,4641
Nikolaj,1,0,72,0,72
Nikolajevna,0,1,0,29,29
Nikolaos,1,0,96,0,96
Nikolas,1,0,1335,0,1335
Nikolaus,1,0,106,0,106
Nikolay,1,0,49,0,49
Nikole,0,1,0,12,12
Nikoletta,0,1,0,13,13
Nikolina,0,1,0,28,28
Niko-Markus,1,0,10,0,10
Niko-Matias,1,0,10,0,10
Niko-Matti,1,0,26,0,26
Nikonpoika,1,0,23,0,23
Niko-Pekka,1,0,52,0,52
Niko-Petri,1,0,16,0,16
Niko-Petteri,1,0,163,0,163
Nikos,1,0,18,0,18
Niko-Ville,1,0,10,0,10
Niku,1,0,117,0,117
Nila,0,1,0,24,24
Nilla,0.248587570621469,0.751412429378531,44,133,177
Nilo,1,0,26,0,26
Nils,1,0,3183,0,3183
Nils-Åke,1,0,11,0,11
Nilsdotter,0,1,0,16,16
Nils-Eric,1,0,21,0,21
Nils-Erik,1,0,188,0,188
Nils-Göran,1,0,28,0,28
Nils-Gustav,1,0,11,0,11
Nils-Henrik,1,0,14,0,14
Nils-Johan,1,0,40,0,40
Nils-Olof,1,0,28,0,28
Nilsson,1,0,10,0,10
Nima,0.772727272727273,0.227272727272727,34,10,44
Nimco,0,1,0,20,20
Nimo,0,1,0,58,58
Nina,0,1,0,15873,15873
Nina-Johanna,0,1,0,11,11
Nina-Liisa,0,1,0,10,10
Nina-Maarit,0,1,0,17,17
Nina-Mari,0,1,0,24,24
Nina-Maria,0,1,0,145,145
Nina-Marie,0,1,0,11,11
Nina-Marika,0,1,0,11,11
Ninel,0,1,0,10,10
Ninetta,0,1,0,27,27
Ninette,0,1,0,47,47
Ninja,0,1,0,334,334
Ninna,0,1,0,264,264
Ninni,0,1,0,1352,1352
Ninni-Maria,0,1,0,10,10
Ninnu,0,1,0,45,45
Nino,1,0,361,0,361
Nio,1,0,11,0,11
Nipa,1,0,19,0,19
Niro,1,0,21,0,21
Nisa,0,1,0,26,26
Nisse,1,0,58,0,58
Nita,0,1,0,765,765
Nitta,0,1,0,114,114
Nizar,1,0,10,0,10
Njeri,0,1,0,19,19
Nnenna,0,1,0,11,11
Noa,0.939179632248939,0.0608203677510608,664,43,707
Noah,1,0,882,0,882
Noak,1,0,16,0,16
Noam,1,0,37,0,37
Noé,1,0,17,0,17
Noel,1,0,2095,0,2095
Noël,1,0,19,0,19
Noeli,1,0,15,0,15
Noelia,0,1,0,46,46
Noella,0,1,0,27,27
Noelle,0,1,0,95,95
Noëlle,0,1,0,11,11
Noemi,0,1,0,41,41
Noémie,0,1,0,10,10
Nolan,1,0,26,0,26
Nomi,0,1,0,25,25
Nona,0,1,0,121,121
Nonna,0,1,0,124,124
Nooa,1,0,2290,0,2290
Nooke,1,0,12,0,12
Noomi,0,1,0,419,419
Noona,0,1,0,211,211
Noor,0.261363636363636,0.738636363636364,23,65,88
Noora,0,1,0,11647,11647
Noora-Emilia,0,1,0,28,28
Noora-Maria,0,1,0,67,67
Noora-Sofia,0,1,0,12,12
Nora,0,1,0,2273,2273
Norah,0,1,0,33,33
Nora-Maria,0,1,0,11,11
Norbert,1,0,24,0,24
Norma,0,1,0,122,122
Norman,1,0,59,0,59
Nour,0.296296296296296,0.703703703703704,16,38,54
Noura,0,1,0,17,17
Noureddine,1,0,23,0,23
Nova,0,1,0,106,106
Novalie,0,1,0,25,25
Nuka,1,0,23,0,23
Nuno,1,0,33,0,33
Nuppu,0,1,0,697,697
Nur,0.374269005847953,0.625730994152047,64,107,171
Nura,0,1,0,22,22
Nuri,1,0,16,0,16
Nuria,0,1,0,10,10
Nuur,0.577777777777778,0.422222222222222,26,19,45
Nuura,0,1,0,17,17
Nuuti,1,0,78,0,78
Nuutti,1,0,2328,0,2328
Nyambura,0,1,0,15,15
Nyrki,1,0,12,0,12
Nyyrikki,1,0,58,0,58
Nyyti,0,1,0,32,32
Oanh,0,1,0,22,22
Obinna,1,0,17,0,17
Octavia,0,1,0,11,11
Odd,1,0,16,0,16
Odelia,0,1,0,42,42
Odert,1,0,57,0,57
Odessa,0,1,0,314,314
Odette,0,1,0,70,70
Odin,1,0,108,0,108
Ofelia,0,1,0,121,121
Ohto,1,0,334,0,334
Oihonna,0,1,0,11,11
Oili,0,1,0,3457,3457
Oilikki,0,1,0,19,19
Oiva,1,0,5560,0,5560
Oivi,0,1,0,79,79
Öjvind,1,0,13,0,13
Okan,1,0,16,0,16
Oke,1,0,60,0,60
Oki,1,0,37,0,37
Okke,1,0,10,0,10
Okko,1,0,815,0,815
Oksana,0,1,0,104,104
Oktay,1,0,14,0,14
Ola,1,0,401,0,401
Olaf,1,0,55,0,55
Olai,1,0,31,0,31
Olaus,1,0,24,0,24
Olav,1,0,740,0,740
Olavi,1,0,147324,0,147324
Olavinpoika,1,0,34,0,34
Ole,1,0,945,0,945
Oleg,1,0,233,0,233
Olegovna,0,1,0,11,11
Oleksandr,1,0,12,0,12
Oleksi,1,0,33,0,33
Olena,0,1,0,42,42
Olesia,0,1,0,14,14
Olesja,0,1,0,18,18
Olessia,0,1,0,15,15
Olesya,0,1,0,15,15
Olga,0,1,0,3627,3627
Olga-Maria,0,1,0,22,22
Oliivia,0,1,0,15,15
Oline,0,1,0,38,38
Olive,0,1,0,15,15
Oliver,1,0,12969,0,12969
Oliveri,1,0,24,0,24
Olivia,0,1,0,15803,15803
Olivier,1,0,89,0,89
Oliwer,1,0,120,0,120
Oliwia,0,1,0,26,26
Olka,0,1,0,25,25
Olle,1,0,302,0,302
Olli,1,0,18608,0,18608
Olli-Antti,1,0,13,0,13
Ollie,1,0,13,0,13
Olli-Heikki,1,0,37,0,37
Olli-Juhani,1,0,26,0,26
Olli-Jukka,1,0,10,0,10
Olli-Jussi,1,0,32,0,32
Olli-Kalle,1,0,11,0,11
Olli-Matias,1,0,10,0,10
Ollimatti,1,0,21,0,21
Olli-Matti,1,0,235,0,235
Olli-Mikko,1,0,20,0,20
Ollinpoika,1,0,150,0,150
Ollintytär,0,1,0,36,36
Olli-Oskari,1,0,13,0,13
Ollipekka,1,0,71,0,71
Olli-Pekka,1,0,2304,0,2304
Olli-Petteri,1,0,95,0,95
Olli-Tapio,1,0,13,0,13
Olli-Veikko,1,0,30,0,30
Olliver,1,0,12,0,12
Olli-Ville,1,0,20,0,20
Olof,1,0,3518,0,3518
Olofsdotter,0,1,0,18,18
Olofsson,1,0,15,0,15
Olov,1,0,96,0,96
Oma,0.538461538461538,0.461538461538462,98,84,182
Omar,0.797619047619048,0.202380952380952,536,136,672
Omed,1,0,11,0,11
Omelia,0,1,0,19,19
Omena,0,1,0,33,33
Omenankukka,0,1,0,11,11
Omer,1,0,50,0,50
Ömer,1,0,45,0,45
Omid,1,0,37,0,37
Ona,0,1,0,117,117
Onerva,0.0024975024975025,0.997502497502498,15,5991,6006
Onervo,1,0,11,0,11
Onna,0,1,0,38,38
Onnea,0,1,0,15,15
Onneli,0,1,0,131,131
Onni,1,0,20230,0,20230
Onnia,0,1,0,61,61
Onni-Eemeli,1,0,23,0,23
Onni-Elmeri,1,0,11,0,11
Onni-Ilmari,1,0,14,0,14
Onni-Kalle,1,0,18,0,18
Onnimanni,1,0,20,0,20
Onni-Matias,1,0,21,0,21
Onni-Matti,1,0,17,0,17
Onni-Oskari,1,0,25,0,25
Onnipekka,1,0,13,0,13
Onni-Pekka,1,0,51,0,51
Onni-Petteri,1,0,13,0,13
Ontrei,1,0,23,0,23
Onur,1,0,23,0,23
Oo,0.5,0.5,10,10,20
Oodi,0,1,0,20,20
Oona,0,1,0,7397,7397
Oona-Emilia,0,1,0,16,16
Oona-Maria,0,1,0,47,47
Oona-Sofia,0,1,0,12,12
Oosa,0,1,0,108,108
Ophelia,0,1,0,11,11
Opri,0,1,0,89,89
Optatus,1,0,10,0,10
Ora,1,0,50,0,50
Oras,1,0,44,0,44
Oren,1,0,11,0,11
Orhan,1,0,30,0,30
Orion,1,0,35,0,35
Örjan,1,0,24,0,24
Orjo,1,0,14,0,14
Orla,0,1,0,13,13
Orlando,1,0,39,0,39
Orma,1,0,11,0,11
Örnulf,1,0,16,0,16
Orson,1,0,10,0,10
Ortamo,1,0,14,0,14
Orvar,1,0,21,0,21
Orvo,0.970175438596491,0.0298245614035088,553,17,570
Orvokki,0,1,0,34138,34138
Osama,1,0,25,0,25
Oscar,1,0,3004,0,3004
Oscari,1,0,26,0,26
Oska,1,0,17,0,17
Oskar,1,0,5394,0,5394
Oskari,1,0,35955,0,35955
Oski,1,0,17,0,17
Osku,1,0,454,0,454
Osma,1,0,39,0,39
Osman,0.744525547445255,0.255474452554745,204,70,274
Osmi,0.263157894736842,0.736842105263158,10,28,38
Osmo,1,0,7484,0,7484
Osmonpoika,1,0,15,0,15
Osmontytär,0,1,0,12,12
Oso,1,0,11,0,11
Osse,1,0,10,0,10
Ossi,1,0,7559,0,7559
Ossian,1,0,2070,0,2070
Ossinpoika,1,0,28,0,28
Ossi-Pekka,1,0,23,0,23
Ossi-Petteri,1,0,14,0,14
Östen,1,0,113,0,113
Osvald,1,0,785,0,785
Oswald,1,0,106,0,106
Otava,1,0,515,0,515
Othilia,0,1,0,16,16
Othman,1,0,11,0,11
Otieno,1,0,11,0,11
Otilia,0,1,0,23,23
Otonpoika,1,0,20,0,20
Otro,1,0,13,0,13
Otso,1,0,3234,0,3234
Otteliaana,0,1,0,48,48
Otteliana,0,1,0,31,31
Otteljaana,0,1,0,27,27
Ottiilia,0,1,0,99,99
Ottilia,0,1,0,525,525
Ottiliana,0,1,0,14,14
Otto,1,0,13495,0,13495
Otto-Eemeli,1,0,13,0,13
Otto-Emil,1,0,13,0,13
Otto-Oskari,1,0,16,0,16
Otto-Pekka,1,0,42,0,42
Otto-Petteri,1,0,11,0,11
Otto-Ville,1,0,83,0,83
Oula,0.982804232804233,0.0171957671957672,743,13,756
Oulas,1,0,17,0,17
Ousman,1,0,13,0,13
Outi,0.00223366028940468,0.997766339710595,23,10274,10297
Outi-Elina,0,1,0,10,10
Outi-Katariina,0,1,0,11,11
Outi-Leena,0,1,0,10,10
Outi-Maaria,0,1,0,11,11
Outi-Mari,0,1,0,13,13
Outi-Maria,0,1,0,49,49
Outi-Marja,0,1,0,13,13
Ove,1,0,788,0,788
Owe,1,0,31,0,31
Owen,1,0,53,0,53
Oxana,0,1,0,106,106
Öyvind,1,0,12,0,12
Ozan,1,0,14,0,14
Özlem,0,1,0,10,10
Ozzy,1,0,11,0,11
Paavali,1,0,3006,0,3006
Paavo,1,0,18446,0,18446
Paavonpoika,1,0,45,0,45
Paavontytär,0,1,0,19,19
Pablo,1,0,108,0,108
Paige,0,1,0,19,19
Päivä,0,1,0,18,18
Päivänsäde,0,1,0,57,57
Päivätär,0,1,0,22,22
Päivi,0,1,0,34077,34077
Päivi-Elina,0,1,0,12,12
Päivi-Helena,0,1,0,23,23
Päivikki,0,1,0,9901,9901
Päivi-Leena,0,1,0,16,16
Päivi-Liisa,0,1,0,20,20
Päivi-Maarit,0,1,0,12,12
Päivi-Maria,0,1,0,26,26
Päivintytär,0,1,0,10,10
Päiviö,0.994540783558125,0.0054592164418754,3097,17,3114
Päivi-Riitta,0,1,0,12,12
Päivi-Sisko,0,1,0,28,28
Päivö,1,0,82,0,82
Päivyt,0,1,0,90,90
Paju,0.110091743119266,0.889908256880734,12,97,109
Pål,1,0,10,0,10
Paloma,0,1,0,105,105
Pälvi,0,1,0,157,157
Pamela,0,1,0,461,461
Pami,0.612903225806452,0.387096774193548,19,12,31
Pan,1,0,11,0,11
Panagiotis,1,0,17,0,17
Pandora,0,1,0,10,10
Panu,1,0,2541,0,2541
Panunpoika,1,0,20,0,20
Panu-Pekka,1,0,15,0,15
Panu-Petteri,1,0,23,0,23
Paola,0,1,0,107,107
Paolo,1,0,88,0,88
Papu,0,1,0,12,12
Pär,1,0,148,0,148
Paraskeva,0,1,0,13,13
Pär-Erik,1,0,17,0,17
Paris,0.515151515151515,0.484848484848485,17,16,33
Parisa,0,1,0,16,16
Pär-Olof,1,0,10,0,10
Pärttyli,1,0,54,0,54
Parvin,0,1,0,17,17
Pascal,1,0,20,0,20
Pasi,1,0,19510,0,19510
Pasi-Matti,1,0,28,0,28
Pasinpoika,1,0,117,0,117
Pasintytär,0,1,0,29,29
Pasi-Pekka,1,0,65,0,65
Pasi-Petteri,1,0,44,0,44
Pate,1,0,34,0,34
Patric,1,0,247,0,247
Patrica,0,1,0,12,12
Patrice,0,1,0,12,12
Patricia,0,1,0,1759,1759
Patricio,1,0,18,0,18
Patrick,1,0,2301,0,2301
Patriicia,0,1,0,16,16
Patrik,1,0,6727,0,6727
Patrikki,1,0,10,0,10
Patrizia,0,1,0,22,22
Patu,1,0,13,0,13
Pau,1,0,11,0,11
Paul,1,0,3341,0,3341
Paula,0,1,0,20125,20125
Paula-Maija,0,1,0,14,14
Paula-Maria,0,1,0,23,23
Paula-Riitta,0,1,0,11,11
Paul-Erik,1,0,69,0,69
Paulette,0,1,0,37,37
Paul-Henrik,1,0,15,0,15
Pauli,1,0,15004,0,15004
Pauliina,0,1,0,29819,29819
Paulikki,0,1,0,21,21
Paulina,0,1,0,1045,1045
Pauline,0,1,0,293,293
Paulinpoika,1,0,36,0,36
Pauli-Petteri,1,0,10,0,10
Paulo,1,0,68,0,68
Paulus,1,0,903,0,903
Pauno,1,0,87,0,87
Pave,1,0,11,0,11
Pavel,1,0,324,0,324
Pavlos,1,0,17,0,17
Pavlovna,0,1,0,18,18
Pawel,1,0,19,0,19
Pearl,0,1,0,14,14
Peder,1,0,85,0,85
Pedram,1,0,15,0,15
Pedro,1,0,132,0,132
Peeta,0,1,0,10,10
Peeter,1,0,50,0,50
Peeti,1,0,18,0,18
Peetro,1,0,12,0,12
Peetter,1,0,33,0,33
Peetu,1,0,1943,0,1943
Peggy,0,1,0,115,115
Pehr,1,0,140,0,140
Pehr-Erik,1,0,31,0,31
Pehr-Olof,1,0,14,0,14
Peik,1,0,254,0,254
Peikko,1,0,17,0,17
Peitsa,1,0,36,0,36
Pekanpoika,1,0,343,0,343
Pekantytär,0,1,0,65,65
Pekka,1,0,81204,0,81204
Pekka-Juhani,1,0,43,0,43
Pekko,1,0,535,0,535
Pelagea,0,1,0,16,16
Pelagia,0,1,0,61,61
Pella,0,1,0,11,11
Pellava,0,1,0,16,16
Pelle,1,0,24,0,24
Pellervo,1,0,3729,0,3729
Pena,1,0,14,0,14
Penelope,0,1,0,49,49
Penja,1,0,11,0,11
Penjami,1,0,81,0,81
Penna,1,0,25,0,25
Penni,0,1,0,54,54
Penny,0,1,0,14,14
Pentinpoika,1,0,90,0,90
Pentintytär,0,1,0,10,10
Pentti,1,0,31294,0,31294
Pepe,1,0,121,0,121
Pepita,0,1,0,159,159
Peppi,0,1,0,2787,2787
Peppiina,0,1,0,978,978
Peppilotta,0,1,0,48,48
Peppi-Lotta,0,1,0,101,101
Peppina,0,1,0,135,135
Per,1,0,1880,0,1880
Per-Åke,1,0,34,0,34
Per-Anders,1,0,27,0,27
Per-Eric,1,0,22,0,22
Per-Erik,1,0,424,0,424
Per-Göran,1,0,19,0,19
Per-Håkan,1,0,35,0,35
Per-Henrik,1,0,39,0,39
Per-Johan,1,0,40,0,40
Perla,0,1,0,26,26
Pernilla,0,1,0,497,497
Per-Ola,1,0,13,0,13
Per-Ole,1,0,92,0,92
Per-Olof,1,0,199,0,199
Per-Ove,1,0,13,0,13
Perry,1,0,14,0,14
Persdotter,0,1,0,13,13
Pertinpoika,1,0,73,0,73
Pertintytär,0,1,0,15,15
Pertta,0,1,0,12,12
Pertteli,1,0,62,0,62
Pertti,1,0,21401,0,21401
Perttu,1,0,2931,0,2931
Perttuli,1,0,38,0,38
Perttyli,1,0,15,0,15
Pertunpoika,1,0,15,0,15
Pessi,1,0,253,0,253
Petar,1,0,15,0,15
Pete,1,0,340,0,340
Peter,0.998632351112769,0.00136764888723113,8032,11,8043
Péter,1,0,20,0,20
Peteri,1,0,15,0,15
Petersdotter,0,1,0,27,27
Petersson,1,0,13,0,13
Pether,1,0,12,0,12
Petja,1,0,578,0,578
Petr,1,0,51,0,51
Petra,0,1,0,6514,6514
Petra-Maria,0,1,0,32,32
Petranella,0,1,0,16,16
Petra-Pauliina,0,1,0,10,10
Petri,1,0,37254,0,37254
Petriikka,0,1,0,24,24
Petriina,0,1,0,429,429
Petri-Juhani,1,0,16,0,16
Petrik,1,0,98,0,98
Petri-Mikael,1,0,12,0,12
Petrina,0,1,0,33,33
Petrinpoika,1,0,170,0,170
Petrintytär,0,1,0,54,54
Petro,1,0,339,0,339
Petronella,0,1,0,284,284
Petros,1,0,40,0,40
Petrov,1,0,12,0,12
Petrovna,0,1,0,22,22
Petrus,1,0,1198,0,1198
Pette,1,0,14,0,14
Petter,1,0,2017,0,2017
Petteri,1,0,73204,0,73204
Petterinpoika,1,0,37,0,37
Pettiina,0,1,0,23,23
Petu,1,0,17,0,17
Phat,1,0,21,0,21
Phi,1,0,23,0,23
Philip,1,0,565,0,565
Philipp,1,0,58,0,58
Philippa,0,1,0,36,36
Philippe,1,0,88,0,88
Phillip,1,0,22,0,22
Phoebe,0,1,0,20,20
Phoenix,1,0,10,0,10
Phong,1,0,54,0,54
Phu,1,0,16,0,16
Phuc,1,0,27,0,27
Phung,0.303030303030303,0.696969696969697,10,23,33
Phuoc,1,0,24,0,24
Phuong,0.154362416107383,0.845637583892617,23,126,149
Pi,0,1,0,39,39
Pia,0,1,0,12379,12379
Pia-Carita,0,1,0,10,10
Pia-Christina,0,1,0,11,11
Pia-Helena,0,1,0,10,10
Pia-Johanna,0,1,0,15,15
Pia-Kristiina,0,1,0,39,39
Pia-Leena,0,1,0,25,25
Pia-Liisa,0,1,0,59,59
Pia-Maarit,0,1,0,22,22
Pia-Mari,0,1,0,49,49
Pia-Maria,0,1,0,237,237
Pia-Marie,0,1,0,14,14
Pia-Marja,0,1,0,14,14
Pian,0,1,0,16,16
Pia-Pauliina,0,1,0,23,23
Pia-Riitta,0,1,0,41,41
Pia-Sofia,0,1,0,25,25
Pia-Susanna,0,1,0,19,19
Piatta,0,1,0,30,30
Piela,0,1,0,19,19
Piera,1,0,17,0,17
Pierre,1,0,95,0,95
Pieta,0,1,0,251,251
Pietari,1,0,3663,0,3663
Pieter,1,0,16,0,16
Pieti,1,0,89,0,89
Pietro,1,0,71,0,71
Pietu,1,0,364,0,364
Pihka,0,1,0,14,14
Pihla,0,1,0,3351,3351
Pihlaja,0,1,0,51,51
Pihla-Maria,0,1,0,25,25
Pii,0,1,0,72,72
Piia,0,1,0,6970,6970
Piia-Johanna,0,1,0,11,11
Piia-Liisa,0,1,0,17,17
Piia-Maarit,0,1,0,12,12
Piia-Mari,0,1,0,19,19
Piia-Maria,0,1,0,45,45
Piia-Pauliina,0,1,0,21,21
Piia-Riikka,0,1,0,12,12
Piia-Riitta,0,1,0,23,23
Piija,0,1,0,16,16
Piiku,0,1,0,20,20
Piipa,0,1,0,15,15
Piippa,0,1,0,10,10
Piita,0,1,0,29,29
Piitu,0,1,0,201,201
Piiu,0,1,0,19,19
Pike,0,1,0,14,14
Pikka,0,1,0,16,16
Piko,1,0,14,0,14
Pilar,0,1,0,18,18
Pilke,0,1,0,13,13
Pille,0,1,0,14,14
Pilvi,0,1,0,1373,1373
Pilvikki,0,1,0,228,228
Pilvi-Sisko,0,1,0,28,28
Pinar,0,1,0,10,10
Ping,0,1,0,19,19
Pinja,0,1,0,5529,5529
Pinja-Maria,0,1,0,22,22
Pioni,0,1,0,16,16
Piotr,1,0,38,0,38
Pipa,0,1,0,26,26
Pipariina,0,1,0,16,16
Piparminttu,0,1,0,10,10
Pippa,0,1,0,29,29
Pipsa,0,1,0,815,815
Piret,0,1,0,35,35
Piretta,0,1,0,27,27
Piri,0,1,0,14,14
Pirita,0,1,0,1582,1582
Piritta,0,1,0,2551,2551
Pirja,0,1,0,60,60
Pirje,0,1,0,10,10
Pirjetta,0,1,0,238,238
Pirjo,0,1,0,30741,30741
Pirjo-Hannele,0,1,0,14,14
Pirjo-Helena,0,1,0,11,11
Pirjo-Kaarina,0,1,0,11,11
Pirjo-Leena,0,1,0,166,166
Pirjo-Liisa,0,1,0,552,552
Pirjoriitta,0,1,0,10,10
Pirjo-Riitta,0,1,0,649,649
Pirjo-Sisko,0,1,0,17,17
Pirke,0,1,0,16,16
Pirketta,0,1,0,99,99
Pirkitta,0,1,0,121,121
Pirkka,0.963730569948187,0.0362694300518135,372,14,386
Pirkka-Pekka,1,0,23,0,23
Pirkko,0,1,0,27228,27228
Pirkko-Helena,0,1,0,12,12
Pirkko-Leena,0,1,0,82,82
Pirkkoliisa,0,1,0,19,19
Pirkko-Liisa,0,1,0,1148,1148
Pirkko-Maija,0,1,0,11,11
Pirkko-Riitta,0,1,0,16,16
Pirpa,0,1,0,16,16
Pirre,0,1,0,125,125
Pirta,0,1,0,81,81
Pirve,0,1,0,11,11
Pjotr,1,0,14,0,14
Platon,1,0,12,0,12
Pohto,1,0,21,0,21
Poika,1,0,102,0,102
Poju,1,0,61,0,61
Polina,0,1,0,130,130
Pomeliina,0,1,0,39,39
Ponteva,1,0,28,0,28
Pontus,1,0,538,0,538
Poppy,0,1,0,25,25
Pouta,0,1,0,10,10
Prasad,1,0,18,0,18
Precious,0,1,0,12,12
Preston,1,0,10,0,10
Pricella,0,1,0,17,17
Pricilla,0,1,0,79,79
Priita,0,1,0,54,54
Priitta,0,1,0,68,68
Prince,1,0,34,0,34
Princess,0,1,0,24,24
Prisca,0,1,0,11,11
Priscilla,0,1,0,101,101
Prisilla,0,1,0,23,23
Priska,0,1,0,35,35
Priskilla,0,1,0,11,11
Priya,0,1,0,23,23
Pui,0,1,0,10,10
Puja,1,0,10,0,10
Pulmu,0,1,0,158,158
Puolukka,0,1,0,18,18
Putte,1,0,16,0,16
Pyry,0.996794871794872,0.00320512820512821,3421,11,3432
Pyry-Pekka,1,0,35,0,35
Pyry-Petteri,1,0,48,0,48
Qamar,0,1,0,16,16
Qasim,1,0,15,0,15
Qian,0,1,0,11,11
Qing,0,1,0,11,11
Quan,1,0,17,0,17
Quang,1,0,74,0,74
Quentin,1,0,17,0,17
Quinn,1,0,10,0,10
Quoc,1,0,79,0,79
Quy,1,0,11,0,11
Quyen,0,1,0,20,20
Quynh,0,1,0,49,49
Raad,1,0,15,0,15
Raafael,1,0,217,0,217
Raakel,0,1,0,2685,2685
Raakeli,0,1,0,141,141
Raakkel,0,1,0,72,72
Raakkeli,0,1,0,51,51
Rabab,0,1,0,12,12
Rabbe,1,0,172,0,172
Rabia,0,1,0,24,24
Rachel,0,1,0,217,217
Rachelle,0,1,0,13,13
Rachid,1,0,56,0,56
Rachida,0,1,0,12,12
Rae,0.235294117647059,0.764705882352941,16,52,68
Raed,1,0,17,0,17
Rafael,1,0,5125,0,5125
Rafaela,0,1,0,108,108
Rafaella,0,1,0,13,13
Raffaele,1,0,19,0,19
Rafi,1,0,18,0,18
Rafik,1,0,20,0,20
Ragna,0,1,0,30,30
Ragnar,1,0,971,0,971
Ragnarsson,1,0,10,0,10
Ragnborg,0,1,0,40,40
Ragnhild,0,1,0,388,388
Ragni,0,1,0,164,164
Ragnvald,1,0,145,0,145
Rahel,0,1,0,17,17
Rahim,1,0,43,0,43
Rahma,0,1,0,43,43
Rahman,1,0,59,0,59
Rahmo,0,1,0,21,21
Rahul,1,0,15,0,15
Rai,1,0,14,0,14
Raif,1,0,10,0,10
Raija,0,1,0,23946,23946
Raija-Leena,0,1,0,171,171
Raija-Liisa,0,1,0,377,377
Raija-Maija,0,1,0,10,10
Raija-Riitta,0,1,0,27,27
Raija-Sisko,0,1,0,11,11
Raika,0,1,0,11,11
Raikas,1,0,113,0,113
Raikko,1,0,45,0,45
Raiko,1,0,13,0,13
Raila,0,1,0,1248,1248
Raile,0,1,0,12,12
Raili,0,1,0,16739,16739
Railikki,0,1,0,15,15
Raimo,1,0,22359,0,22359
Raimond,1,0,44,0,44
Raimonpoika,1,0,35,0,35
Raimontytär,0,1,0,13,13
Rain,1,0,13,0,13
Raina,0,1,0,88,88
Raine,0.992392807745505,0.00760719225449516,1435,11,1446
Rainer,1,0,7153,0,7153
Raineri,1,0,510,0,510
Rainerinpoika,1,0,12,0,12
Raini,0,1,0,118,118
Rainier,1,0,11,0,11
Raino,1,0,627,0,627
Raisa,0,1,0,1534,1534
Raissa,0,1,0,27,27
Raita,0,1,0,364,364
Raivo,1,0,14,0,14
Raj,1,0,16,0,16
Raja,1,0,10,0,10
Rakel,0,1,0,1673,1673
Ralf,1,0,1684,0,1684
Ralf-Erik,1,0,13,0,13
Ralph,1,0,106,0,106
Ram,1,0,21,0,21
Ramadan,1,0,21,0,21
Raman,1,0,15,0,15
Ramazan,1,0,25,0,25
Rami,1,0,3659,0,3659
Ramil,1,0,11,0,11
Ramin,1,0,58,0,58
Raminpoika,1,0,33,0,33
Rami-Pekka,1,0,17,0,17
Ramla,0,1,0,26,26
Ramon,1,0,53,0,53
Ramón,1,0,10,0,10
Ramona,0,1,0,596,596
Ramses,1,0,54,0,54
Ramzi,1,0,22,0,22
Rana,0,1,0,33,33
Randa,0,1,0,14,14
Randall,1,0,12,0,12
Randi,0,1,0,10,10
Randolf,1,0,13,0,13
Randolph,1,0,12,0,12
Randy,1,0,17,0,17
Rane,1,0,29,0,29
Ranghild,0,1,0,21,21
Rani,0.547619047619048,0.452380952380952,23,19,42
Rania,0,1,0,90,90
Ranja,0,1,0,167,167
Ranjit,1,0,11,0,11
Ransu,1,0,15,0,15
Ranya,0,1,0,18,18
Raoul,1,0,160,0,160
Raphael,1,0,84,0,84
Raphaël,1,0,26,0,26
Raquel,0,1,0,33,33
Rasha,0,1,0,10,10
Rashed,1,0,10,0,10
Rasheed,1,0,13,0,13
Rashid,0.69047619047619,0.30952380952381,58,26,84
Rasim,1,0,11,0,11
Rasmus,1,0,7753,0,7753
Rauf,1,0,15,0,15
Rauha,0,1,0,4807,4807
Raul,1,0,278,0,278
Raúl,1,0,10,0,10
Rauli,1,0,1460,0,1460
Rauna,0,1,0,117,117
Raune,0,1,0,13,13
Rauni,0.0627624309392265,0.937237569060773,284,4241,4525
Rauno,1,0,8190,0,8190
Raunonpoika,1,0,25,0,25
Raunontytär,0,1,0,14,14
Rautia,1,0,10,0,10
Ravi,1,0,11,0,11
Ray,1,0,140,0,140
Rayaan,0,1,0,20,20
Rayan,0.775510204081633,0.224489795918367,76,22,98
Raymond,1,0,276,0,276
Raza,1,0,12,0,12
Razia,0,1,0,10,10
Rea,0,1,0,818,818
Rebaz,1,0,11,0,11
Rebeca,0,1,0,28,28
Rebecca,0,1,0,1393,1393
Rebecka,0,1,0,619,619
Rebekah,0,1,0,22,22
Rebekka,0,1,0,1888,1888
Rebin,1,0,15,0,15
Rebwar,1,0,18,0,18
Reda,1,0,25,0,25
Reea,0,1,0,214,214
Reem,0,1,0,10,10
Reena,0,1,0,13,13
Reet,0,1,0,21,21
Reeta,0,1,0,1945,1945
Reeta-Kaisa,0,1,0,17,17
Reeta-Mari,0,1,0,14,14
Reeta-Maria,0,1,0,19,19
Reeti,1,0,97,0,97
Reetriikka,0,1,0,14,14
Reetrikki,1,0,28,0,28
Reetta,0,1,0,5474,5474
Reetta-Kaisa,0,1,0,34,34
Reetta-Leena,0,1,0,35,35
Reetta-Liisa,0,1,0,49,49
Reetta-Maija,0,1,0,22,22
Reetta-Mari,0,1,0,17,17
Reetta-Maria,0,1,0,34,34
Reetu,1,0,81,0,81
Regiina,0,1,0,24,24
Regina,0,1,0,2597,2597
Regine,0,1,0,10,10
Reguel,1,0,40,0,40
Reh,1,0,44,0,44
Rei,1,0,11,0,11
Reidar,1,0,110,0,110
Reija,0,1,0,1835,1835
Reija-Leena,0,1,0,11,11
Reija-Liisa,0,1,0,18,18
Reija-Riitta,0,1,0,10,10
Reijo,1,0,19024,0,19024
Reijonpoika,1,0,53,0,53
Reijontytär,0,1,0,11,11
Reima,1,0,2269,0,2269
Reimo,1,0,26,0,26
Rein,1,0,27,0,27
Reina,0,1,0,28,28
Reine,0.182795698924731,0.817204301075269,17,76,93
Reinhard,1,0,32,0,32
Reinhold,1,0,517,0,517
Reini,0.8,0.2,40,10,50
Reino,1,0,10660,0,10660
Reinonpoika,1,0,14,0,14
Reipas,1,0,35,0,35
Reittu,1,0,33,0,33
Réka,0,1,0,13,13
Reko,1,0,601,0,601
Remi,1,0,87,0,87
Rémi,1,0,10,0,10
Remo,1,0,44,0,44
Remu,1,0,169,0,169
Remus,1,0,31,0,31
Remy,1,0,28,0,28
Rena,0,1,0,12,12
Renata,0,1,0,103,103
Renate,0,1,0,88,88
Renato,1,0,15,0,15
Rene,0.971428571428571,0.0285714285714286,612,18,630
René,0.97134670487106,0.0286532951289398,339,10,349
Renee,0,1,0,58,58
Renée,0,1,0,69,69
Reni,1,0,20,0,20
Renita,0,1,0,19,19
Renja,0,1,0,144,144
Renne,1,0,248,0,248
Renni,1,0,21,0,21
Renny,1,0,90,0,90
Reno,1,0,12,0,12
Reo,1,0,13,0,13
Repe,1,0,17,0,17
Repekka,0,1,0,43,43
Retriika,0,1,0,30,30
Retriikka,0,1,0,23,23
Retu,1,0,48,0,48
Reuben,1,0,13,0,13
Revontuli,1,0,11,0,11
Rex,1,0,24,0,24
Rey,1,0,11,0,11
Reza,1,0,91,0,91
Rhea,0,1,0,118,118
Rhonda,0,1,0,13,13
Rhys,1,0,12,0,12
Ria,0,1,0,589,589
Riad,1,0,25,0,25
Ria-Maria,0,1,0,16,16
Riana,0,1,0,13,13
Rianna,0,1,0,249,249
Rianne,0,1,0,10,10
Ricardo,1,0,174,0,174
Riccardo,1,0,35,0,35
Richard,1,0,2577,0,2577
Richardo,1,0,16,0,16
Richart,1,0,14,0,14
Rick,1,0,30,0,30
Rickard,1,0,332,0,332
Rickhard,1,0,218,0,218
Ricky,1,0,54,0,54
Rico,1,0,209,0,209
Rida,1,0,15,0,15
Ridwan,1,0,22,0,22
Rieti,1,0,28,0,28
Righard,1,0,17,0,17
Rigmor,0,1,0,117,117
Riham,0,1,0,11,11
Rihanna,0,1,0,26,26
Riia,0,1,0,973,973
Riia-Liisa,0,1,0,13,13
Riia-Maria,0,1,0,29,29
Riija,0,1,0,13,13
Riika,0,1,0,419,419
Riikka,0,1,0,13538,13538
Riikka-Elina,0,1,0,10,10
Riikka-Johanna,0,1,0,14,14
Riikka-Leena,0,1,0,58,58
Riikkaliisa,0,1,0,17,17
Riikka-Liisa,0,1,0,133,133
Riikka-Maaria,0,1,0,14,14
Riikka-Maija,0,1,0,27,27
Riikkamari,0,1,0,11,11
Riikka-Mari,0,1,0,52,52
Riikka-Maria,0,1,0,108,108
Riikka-Sisko,0,1,0,11,11
Riikka-Susanna,0,1,0,11,11
Riiko,1,0,61,0,61
Riim,0,1,0,13,13
Riina,0,1,0,5625,5625
Riina-Kaisa,0,1,0,20,20
Riina-Liisa,0,1,0,15,15
Riina-Lotta,0,1,0,11,11
Riina-Maija,0,1,0,22,22
Riina-Mari,0,1,0,19,19
Riina-Maria,0,1,0,68,68
Riinu,0,1,0,12,12
Riita,0,1,0,11,11
Riitta,0,1,0,39971,39971
Riitta-Anneli,0,1,0,21,21
Riitta-Helena,0,1,0,16,16
Riitta-Kaarina,0,1,0,16,16
Riitta-Kaisa,0,1,0,44,44
Riitta-Leena,0,1,0,244,244
Riittaliisa,0,1,0,25,25
Riitta-Liisa,0,1,0,1838,1838
Riitta-Maija,0,1,0,194,194
Riitta-Mari,0,1,0,20,20
Riitta-Maria,0,1,0,37,37
Riitta-Marja,0,1,0,31,31
Riitta-Sisko,0,1,0,54,54
Riitu,0,1,0,70,70
Rika,0,1,0,13,13
Rikard,1,0,165,0,165
Rikhard,1,0,4045,0,4045
Rikhart,1,0,68,0,68
Riki,1,0,105,0,105
Riko,1,0,84,0,84
Riku,1,0,8480,0,8480
Rikumatti,1,0,12,0,12
Riku-Matti,1,0,71,0,71
Rikunpoika,1,0,31,0,31
Riku-Pekka,1,0,127,0,127
Riku-Petteri,1,0,119,0,119
Riku-Ville,1,0,25,0,25
Riley,1,0,14,0,14
Rilla,0,1,0,99,99
Rim,0,1,0,16,16
Rima,0,1,0,10,10
Rimma,0,1,0,37,37
Rina,0,1,0,165,165
Rinaldo,1,0,89,0,89
Rinesa,0,1,0,12,12
Ringa,0,1,0,128,128
Ringo,1,0,24,0,24
Rinja,0,1,0,42,42
Rinna,0,1,0,105,105
Rino,1,0,34,0,34
Rinor,1,0,15,0,15
Rio,1,0,57,0,57
Riona,0,1,0,12,12
Ripsa,0,1,0,31,31
Rispa,0,1,0,11,11
Rista,0,1,0,13,13
Risten,0,1,0,21,21
Ristiina,0,1,0,97,97
Risto,1,0,22526,0,22526
Ristomatti,1,0,60,0,60
Risto-Matti,1,0,161,0,161
Ristonpoika,1,0,127,0,127
Ristontytär,0,1,0,36,36
Risto-Pekka,1,0,74,0,74
Rita,0,1,0,2052,2052
Rita-Maria,0,1,0,13,13
Ritja,0,1,0,13,13
Ritu,0,1,0,12,12
Ritva,0,1,0,34000,34000
Ritva-Anneli,0,1,0,20,20
Ritva-Leena,0,1,0,130,130
Ritvaliisa,0,1,0,20,20
Ritva-Liisa,0,1,0,611,611
Ritva-Maija,0,1,0,15,15
River,1,0,23,0,23
Roald,1,0,30,0,30
Robbie,1,0,22,0,22
Robert,1,0,6875,0,6875
Roberta,0,1,0,45,45
Roberth,1,0,15,0,15
Robertino,1,0,145,0,145
Roberto,1,0,244,0,244
Robertsdotter,0,1,0,19,19
Robi,1,0,69,0,69
Robin,0.994853523357086,0.0051464766429137,2513,13,2526
Robinson,1,0,20,0,20
Robyn,0,1,0,18,18
Rocco,1,0,21,0,21
Rochelle,0,1,0,11,11
Rock,1,0,11,0,11
Rocky,1,0,21,0,21
Roda,0,1,0,20,20
Rode,0,1,0,38,38
Roderick,1,0,15,0,15
Rodi,1,0,29,0,29
Rodion,1,0,20,0,20
Rodney,1,0,21,0,21
Rodolfo,1,0,20,0,20
Rodrigo,1,0,29,0,29
Roger,1,0,1686,0,1686
Rogert,1,0,19,0,19
Rohan,1,0,19,0,19
Roi,1,0,122,0,122
Roihu,1,0,13,0,13
Roine,0.822916666666667,0.177083333333333,79,17,96
Roki,1,0,15,0,15
Roland,1,0,705,0,705
Rolf,1,0,2176,0,2176
Rolf-Erik,1,0,13,0,13
Rolfsdotter,0,1,0,14,14
Rolfsson,1,0,11,0,11
Rolle,1,0,114,0,114
Roman,1,0,295,0,295
Romana,0,1,0,12,12
Romano,1,0,14,0,14
Romeo,1,0,581,0,581
Romi,1,0,43,0,43
Romina,0,1,0,14,14
Ron,1,0,190,0,190
Rona,0,1,0,16,16
Ronald,1,0,244,0,244
Ronaldo,1,0,25,0,25
Ronan,1,0,26,0,26
Ronda,0,1,0,19,19
Roni,1,0,4554,0,4554
Ronia,0,1,0,19,19
Ronin,1,0,10,0,10
Roni-Petteri,1,0,10,0,10
Ronja,0,1,0,4936,4936
Ronja-Maria,0,1,0,13,13
Ronni,1,0,40,0,40
Ronnie,1,0,265,0,265
Ronny,1,0,462,0,462
Rony,1,0,258,0,258
Ronya,0,1,0,71,71
Roo,1,0,10,0,10
Roobert,1,0,105,0,105
Roomeo,1,0,20,0,20
Roope,1,0,6500,0,6500
Roope-Oskari,1,0,12,0,12
Roopert,1,0,23,0,23
Roopertti,1,0,65,0,65
Roosa,0,1,0,7249,7249
Roosa-Emilia,0,1,0,22,22
Roosaliina,0,1,0,11,11
Roosa-Maaria,0,1,0,47,47
Roosa-Maija,0,1,0,13,13
Roosamari,0,1,0,36,36
Roosa-Mari,0,1,0,38,38
Roosamaria,0,1,0,26,26
Roosa-Maria,0,1,0,453,453
Roosa-Marja,0,1,0,12,12
Roosa-Sofia,0,1,0,10,10
Ropi,1,0,17,0,17
Rory,1,0,13,0,13
Rosa,0,1,0,2994,2994
Rosabella,0,1,0,17,17
Rosa-Emilia,0,1,0,17,17
Rosali,0,1,0,11,11
Rosalia,0,1,0,183,183
Rosalie,0,1,0,140,140
Rosaliina,0,1,0,254,254
Rosa-Liina,0,1,0,12,12
Rosalin,0,1,0,17,17
Rosalina,0,1,0,70,70
Rosalinda,0,1,0,63,63
Rosa-Linda,0,1,0,13,13
Rosalyn,0,1,0,10,10
Rosa-Maaria,0,1,0,16,16
Rosamari,0,1,0,11,11
Rosa-Mari,0,1,0,17,17
Rosamaria,0,1,0,37,37
Rosa-Maria,0,1,0,329,329
Rosa-Marie,0,1,0,35,35
Rosana,0,1,0,11,11
Rosanna,0,1,0,584,584
Rosanne,0,1,0,49,49
Rosario,0,1,0,23,23
Rose,0,1,0,526,526
Rosella,0,1,0,15,15
Rose-Maj,0,1,0,115,115
Rose-Mari,0,1,0,23,23
Rose-Maria,0,1,0,11,11
Rosemarie,0,1,0,51,51
Rose-Marie,0,1,0,292,292
Rosemary,0,1,0,42,42
Rose-May,0,1,0,28,28
Rosetta,0,1,0,17,17
Rosette,0,1,0,13,13
Roshan,1,0,11,0,11
Rosi,0,1,0,37,37
Rosie,0,1,0,23,23
Rosiina,0,1,0,16,16
Rosina,0,1,0,105,105
Rosita,0,1,0,671,671
Ros-Maj,0,1,0,28,28
Rosmari,0,1,0,23,23
Ros-Mari,0,1,0,122,122
Rosmarie,0,1,0,20,20
Ros-Marie,0,1,0,70,70
Rosmariini,0,1,0,23,23
Ross,1,0,42,0,42
Rostislav,1,0,12,0,12
Roswitha,0,1,0,12,12
Rowan,1,0,11,0,11
Roxana,0,1,0,30,30
Roxanne,0,1,0,20,20
Roy,1,0,831,0,831
Roya,0,1,0,19,19
Roza,0,1,0,52,52
Rozalia,0,1,0,10,10
Ruben,1,0,604,0,604
Ruby,0,1,0,54,54
Rudi,1,0,86,0,86
Rudolf,1,0,1169,0,1169
Rudy,1,0,27,0,27
Rufus,1,0,149,0,149
Rui,1,0,18,0,18
Runa,0,1,0,148,148
Runa-Lisa,0,1,0,17,17
Runar,1,0,662,0,662
Rune,1,0,696,0,696
Runo,0.774774774774775,0.225225225225225,86,25,111
Rupert,1,0,17,0,17
Rurik,1,0,301,0,301
Ruska,0.0952380952380952,0.904761904761905,12,114,126
Ruslan,1,0,55,0,55
Russell,1,0,25,0,25
Rut,0,1,0,386,386
Ruth,0,1,0,1001,1001
Ruu,0.571428571428571,0.428571428571429,20,15,35
Ruuben,1,0,93,0,93
Ruudolf,1,0,33,0,33
Ruupert,1,0,12,0,12
Ruurik,1,0,14,0,14
Ruusa,0,1,0,310,310
Ruusu,0,1,0,438,438
Ruusu-Maria,0,1,0,18,18
Ruusunnuppu,0,1,0,13,13
Ruut,0,1,0,894,894
Ruuth,0,1,0,37,37
Ryan,1,0,183,0,183
Ryszard,1,0,14,0,14
S.,1,0,13,0,13
Saabir,1,0,10,0,10
Saabiriin,0,1,0,10,10
Saad,0.808219178082192,0.191780821917808,59,14,73
Saadia,0,1,0,11,11
Saaga,0,1,0,968,968
Saamuel,1,0,15,0,15
Saana,0,1,0,4307,4307
Saana-Maria,0,1,0,51,51
Saana-Tuulia,0,1,0,14,14
Saania,0,1,0,13,13
Saara,0,1,0,13294,13294
Saara-Elina,0,1,0,12,12
Saarah,0,1,0,13,13
Saarai,0,1,0,11,11
Saara-Kaisa,0,1,0,39,39
Saara-Leena,0,1,0,26,26
Saara-Liisa,0,1,0,41,41
Saara-Lotta,0,1,0,15,15
Saara-Maija,0,1,0,45,45
Saara-Mari,0,1,0,15,15
Saaramaria,0,1,0,16,16
Saara-Maria,0,1,0,141,141
Saara-Sofia,0,1,0,35,35
Saarni,1,0,22,0,22
Saba,0,1,0,29,29
Sabah,0.522727272727273,0.477272727272727,23,21,44
Saber,1,0,14,0,14
Sabiha,0,1,0,14,14
Sabiina,0,1,0,17,17
Sabina,0,1,0,982,982
Sabine,0,1,0,188,188
Sabir,1,0,18,0,18
Sabit,1,0,15,0,15
Sabri,1,0,21,0,21
Sabriina,0,1,0,27,27
Sabrin,0,1,0,28,28
Sabrina,0,1,0,327,327
Sabrine,0,1,0,10,10
Sacha,1,0,29,0,29
Sadaf,0,1,0,16,16
Sade,0,1,0,418,418
Säde,0,1,0,1675,1675
Sadehelmi,0,1,0,11,11
Sadetta,0,1,0,40,40
Sadi,1,0,11,0,11
Sadia,0,1,0,35,35
Sadie,0,1,0,18,18
Sadik,1,0,21,0,21
Sadio,0,1,0,11,11
Sadiq,1,0,17,0,17
Saeed,0.790322580645161,0.209677419354839,49,13,62
Saeid,1,0,13,0,13
Safa,0,1,0,32,32
Safaa,0,1,0,10,10
Safet,1,0,15,0,15
Saffron,0,1,0,10,10
Safi,0,1,0,11,11
Safia,0,1,0,122,122
Safiina,0,1,0,11,11
Safiira,0,1,0,36,36
Safina,0,1,0,27,27
Safira,0,1,0,113,113
Safiya,0,1,0,51,51
Safiye,0,1,0,14,14
Safiyo,0,1,0,12,12
Saga,0,1,0,2646,2646
Sagal,0,1,0,32,32
Saga-Maria,0,1,0,14,14
Saga-Sofia,0,1,0,14,14
Sahal,0,1,0,11,11
Sahar,0,1,0,47,47
Sahara,0,1,0,11,11
Sahin,1,0,10,0,10
Sahra,0,1,0,89,89
Sahro,0,1,0,17,17
Sai,1,0,10,0,10
Said,0.781931464174455,0.218068535825545,251,70,321
Saida,0,1,0,181,181
Saidi,0,1,0,14,14
Saido,0,1,0,13,13
Saif,1,0,22,0,22
Saiga,0,1,0,10,10
Saiid,1,0,10,0,10
Saija,0,1,0,3997,3997
Saija-Leena,0,1,0,38,38
Saija-Liisa,0,1,0,17,17
Saija-Maria,0,1,0,17,17
Saija-Riikka,0,1,0,15,15
Saija-Riitta,0,1,0,11,11
Saila,0,1,0,2263,2263
Saila-Maria,0,1,0,11,11
Saili,0,1,0,32,32
Saima,0,1,0,1591,1591
Saimi,0,1,0,3012,3012
Saina,0,1,0,27,27
Saini,0,1,0,751,751
Sakari,1,0,65997,0,65997
Sakaria,1,0,38,0,38
Sakarias,1,0,808,0,808
Sakarinpoika,1,0,22,0,22
Sakariye,1,0,34,0,34
Sakeus,1,0,19,0,19
Saki,1,0,15,0,15
Sakina,0,1,0,13,13
Sakke,1,0,164,0,164
Sakkeus,1,0,14,0,14
Sakri,1,0,37,0,37
Saku,1,0,4210,0,4210
Saku-Matti,1,0,14,0,14
Sakunpoika,1,0,18,0,18
Saku-Pekka,1,0,29,0,29
Saku-Petteri,1,0,54,0,54
Sakura,0,1,0,24,24
Salad,0.526315789473684,0.473684210526316,30,27,57
Salah,0.759036144578313,0.240963855421687,63,20,83
Salam,1,0,22,0,22
Salama,0.791666666666667,0.208333333333333,95,25,120
Salar,1,0,17,0,17
Saleban,0.6,0.4,15,10,25
Saleem,1,0,12,0,12
Saleh,0.792452830188679,0.207547169811321,42,11,53
Salem,1,0,39,0,39
Salih,0.733333333333333,0.266666666666667,33,12,45
Salim,1,0,57,0,57
Salima,0,1,0,19,19
Salina,0,1,0,23,23
Salka,0,1,0,35,35
Salla,0,1,0,5847,5847
Salla-Kaisa,0,1,0,18,18
Salla-Maaret,0,1,0,16,16
Sallamaari,0,1,0,113,113
Salla-Maari,0,1,0,21,21
Sallamaaria,0,1,0,14,14
Salla-Maaria,0,1,0,98,98
Sallamaarit,0,1,0,10,10
Salla-Maarit,0,1,0,76,76
Salla-Maija,0,1,0,27,27
Sallamari,0,1,0,214,214
Salla-Mari,0,1,0,300,300
Sallamaria,0,1,0,31,31
Salla-Maria,0,1,0,151,151
Salla-Marja,0,1,0,14,14
Salla-Riikka,0,1,0,13,13
Sallariina,0,1,0,10,10
Salla-Sofia,0,1,0,18,18
Salla-Tuulia,0,1,0,14,14
Salli,0,1,0,2048,2048
Sallima,0,1,0,16,16
Sally,0,1,0,252,252
Salma,0,1,0,222,222
Salmaan,1,0,15,0,15
Salman,0.625,0.375,35,21,56
Salme,0,1,0,5385,5385
Salo,1,0,15,0,15
Salome,0,1,0,265,265
Salomo,1,0,512,0,512
Salomon,1,0,1360,0,1360
Salomoni,1,0,33,0,33
Salu,1,0,11,0,11
Salvador,1,0,34,0,34
Salvatore,1,0,32,0,32
Salvia,0,1,0,12,12
Sam,1,0,564,0,564
Saman,1,0,33,0,33
Samantha,0,1,0,150,150
Samar,0,1,0,16,16
Samatar,1,0,10,0,10
Samba,1,0,13,0,13
Sameer,1,0,15,0,15
Sameh,1,0,14,0,14
Sameli,1,0,566,0,566
Samer,1,0,14,0,14
Samet,1,0,10,0,10
Sami,1,0,27744,0,27744
Samia,0,1,0,32,32
Sami-Antti,1,0,15,0,15
Samiel,1,0,10,0,10
Samiira,0,1,0,26,26
Sami-Jukka,1,0,21,0,21
Sami-Jussi,1,0,21,0,21
Sami-Kristian,1,0,11,0,11
Sami-Matti,1,0,26,0,26
Sami-Mikael,1,0,10,0,10
Samina,0,1,0,12,12
Saminpoika,1,0,117,0,117
Samintytär,0,1,0,33,33
Sami-Pekka,1,0,182,0,182
Sami-Petri,1,0,28,0,28
Sami-Petteri,1,0,177,0,177
Samir,0.963333333333333,0.0366666666666667,289,11,300
Samira,0,1,0,358,358
Sami-Ville,1,0,22,0,22
Sammeli,1,0,255,0,255
Sammy,1,0,137,0,137
Samo,1,0,12,0,12
Sampo,1,0,3324,0,3324
Samponpoika,1,0,10,0,10
Samppa,1,0,449,0,449
Sampsa,1,0,1159,0,1159
Samsa,1,0,11,0,11
Samsam,0,1,0,31,31
Samson,1,0,30,0,30
Samu,1,0,5707,0,5707
Samuel,1,0,18467,0,18467
Samuela,0,1,0,15,15
Samuele,1,0,17,0,17
Samueli,1,0,60,0,60
Samuli,1,0,23598,0,23598
Samulinpoika,1,0,27,0,27
Samu-Pekka,1,0,30,0,30
Samu-Petteri,1,0,35,0,35
Samu-Ville,1,0,16,0,16
Samy,1,0,39,0,39
San,0.5,0.5,14,14,28
Sana,0,1,0,25,25
Sanaa,0,1,0,13,13
Sanaz,0,1,0,11,11
Sander,1,0,75,0,75
Sandi,0,1,0,12,12
Sandor,1,0,36,0,36
Sándor,1,0,21,0,21
Sandra,0,1,0,2395,2395
Sandra-Sofia,0,1,0,15,15
Sandrine,0,1,0,12,12
Sandro,1,0,25,0,25
Sandy,0,1,0,29,29
Sane,0,1,0,16,16
Sanela,0,1,0,15,15
Sanelma,0,1,0,3397,3397
Sanfrid,1,0,146,0,146
Sang,1,0,21,0,21
Sani,0.0573122529644269,0.942687747035573,29,477,506
Sania,0,1,0,34,34
Sanita,0,1,0,12,12
Sanja,0,1,0,316,316
Sanjay,1,0,13,0,13
Sankari,1,0,11,0,11
Sanna,0,1,0,22635,22635
Sanna-Elina,0,1,0,10,10
Sanna-Helena,0,1,0,10,10
Sanna-Kaija,0,1,0,10,10
Sannakaisa,0,1,0,48,48
Sanna-Kaisa,0,1,0,492,492
Sannaleena,0,1,0,28,28
Sanna-Leena,0,1,0,209,209
Sannaliisa,0,1,0,14,14
Sanna-Liisa,0,1,0,173,173
Sanna-Maaria,0,1,0,48,48
Sanna-Maarit,0,1,0,91,91
Sannamaija,0,1,0,33,33
Sanna-Maija,0,1,0,240,240
Sannamari,0,1,0,241,241
Sanna-Mari,0,1,0,1000,1000
Sannamaria,0,1,0,30,30
Sanna-Maria,0,1,0,480,480
Sanna-Marika,0,1,0,30,30
Sanna-Marja,0,1,0,34,34
Sanna-Pauliina,0,1,0,13,13
Sanna-Reetta,0,1,0,12,12
Sanna-Riikka,0,1,0,71,71
Sanna-Riina,0,1,0,14,14
Sanna-Riitta,0,1,0,32,32
Sanna-Sofia,0,1,0,14,14
Sanna-Tuulia,0,1,0,13,13
Sanne,0,1,0,65,65
Sanni,0,1,0,8115,8115
Sanniina,0,1,0,60,60
Sannika,0,1,0,13,13
Sanni-Kaisa,0,1,0,16,16
Sanni-Maija,0,1,0,14,14
Sannimari,0,1,0,18,18
Sanni-Mari,0,1,0,50,50
Sannimaria,0,1,0,10,10
Sanni-Maria,0,1,0,52,52
Sanni-Sofia,0,1,0,39,39
Sannu,0,1,0,20,20
Sannukka,0,1,0,30,30
Sanny,0,1,0,25,25
Sansa,0,1,0,12,12
Sante,1,0,38,0,38
Santeri,1,0,16216,0,16216
Santero,1,0,16,0,16
Santi,1,0,12,0,12
Santiago,1,0,51,0,51
Santino,1,0,22,0,22
Santos,1,0,15,0,15
Santra,0,1,0,196,196
Santtu,1,0,2731,0,2731
Santtu-Pekka,1,0,10,0,10
Sanya,0,1,0,12,12
Sara,0,1,0,13913,13913
Sara-Emilia,0,1,0,19,19
Sarafiina,0,1,0,10,10
Sarafina,0,1,0,16,16
Sarah,0,1,0,1003,1003
Sarai,0,1,0,33,33
Sara-Julia,0,1,0,15,15
Saralia,0,1,0,12,12
Saraliina,0,1,0,11,11
Sara-Lotta,0,1,0,16,16
Sara-Maaria,0,1,0,10,10
Saramaria,0,1,0,11,11
Sara-Maria,0,1,0,97,97
Sara-Marie,0,1,0,13,13
Saranda,0,1,0,35,35
Saranna,0,1,0,27,27
Sara-Sofia,0,1,0,159,159
Saraste,0,1,0,10,10
Sara-Tuuli,0,1,0,12,12
Sara-Tuulia,0,1,0,17,17
Sardar,1,0,14,0,14
Sargit,0,1,0,44,44
Sari,0,1,0,29526,29526
Saria,0,1,0,26,26
Sarianna,0,1,0,611,611
Sari-Anna,0,1,0,55,55
Sarianne,0,1,0,374,374
Sari-Anne,0,1,0,111,111
Sari-Anneli,0,1,0,22,22
Sari-Hannele,0,1,0,13,13
Sari-Helena,0,1,0,20,20
Sariina,0,1,0,30,30
Sari-Johanna,0,1,0,20,20
Sarika,0,1,0,72,72
Sari-Leena,0,1,0,16,16
Sari-Liisa,0,1,0,13,13
Sari-Maarit,0,1,0,41,41
Sari-Maija,0,1,0,13,13
Sari-Maria,0,1,0,15,15
Sari-Marjut,0,1,0,10,10
Sari-Minna,0,1,0,10,10
Sarina,0,1,0,111,111
Sari-Sisko,0,1,0,11,11
Sari-Susanna,0,1,0,31,31
Sarita,0,1,0,1105,1105
Saritta,0,1,0,25,25
Sarleena,0,1,0,12,12
Sarlotta,0,1,0,173,173
Sarmad,1,0,11,0,11
Sarra,0,1,0,13,13
Sarri,0,1,0,62,62
Sasa,0.56,0.44,28,22,50
Sascha,1,0,16,0,16
Sasha,0.69,0.31,69,31,100
Saska,1,0,196,0,196
Saskia,0,1,0,189,189
Sasu,1,0,750,0,750
Sätene,0,1,0,25,25
Sattar,1,0,13,0,13
Satu,0,1,0,25201,25201
Satu-Anna,0,1,0,10,10
Satu-Elina,0,1,0,14,14
Satu-Hannele,0,1,0,16,16
Satu-Helena,0,1,0,22,22
Satu-Johanna,0,1,0,26,26
Satu-Kaarina,0,1,0,18,18
Satu-Kristiina,0,1,0,12,12
Satu-Leena,0,1,0,10,10
Satu-Liisa,0,1,0,19,19
Satu-Lotta,0,1,0,18,18
Satu-Maaret,0,1,0,13,13
Satu-Maaria,0,1,0,78,78
Satu-Maarit,0,1,0,211,211
Satu-Maija,0,1,0,20,20
Satu-Mari,0,1,0,19,19
Satumaria,0,1,0,17,17
Satu-Maria,0,1,0,127,127
Satu-Marika,0,1,0,11,11
Satumarja,0,1,0,10,10
Satu-Marja,0,1,0,82,82
Satu-Marjaana,0,1,0,12,12
Satu-Marjut,0,1,0,11,11
Satu-Päivi,0,1,0,19,19
Satu-Päivikki,0,1,0,21,21
Satu-Riitta,0,1,0,10,10
Satu-Sinikka,0,1,0,61,61
Satu-Sisko,0,1,0,42,42
Satu-Susanna,0,1,0,25,25
Satu-Tuulia,0,1,0,11,11
Saul,1,0,222,0,222
Sauli,1,0,4632,0,4632
Saulinpoika,1,0,12,0,12
Saulus,1,0,11,0,11
Savanna,0,1,0,65,65
Savannah,0,1,0,85,85
Savas,1,0,11,0,11
Sävel,0,1,0,12,12
Sävele,0,1,0,13,13
Saveli,1,0,14,0,14
Savva,1,0,16,0,16
Sävy,0,1,0,48,48
Sayd,1,0,11,0,11
Sayed,1,0,65,0,65
Saynab,0,1,0,16,16
Scarlett,0,1,0,52,52
Scott,1,0,108,0,108
Sea,0,1,0,14,14
Sead,1,0,11,0,11
Seamus,1,0,10,0,10
Sean,1,0,158,0,158
Seán,1,0,16,0,16
Sebastian,1,0,13108,0,13108
Sebastián,1,0,16,0,16
Sebastiano,1,0,10,0,10
Sebastien,1,0,61,0,61
Sébastien,1,0,44,0,44
Secilia,0,1,0,20,20
Seda,0,1,0,12,12
Seea,0,1,0,23,23
Seela,0,1,0,1178,1178
Seelia,0,1,0,132,132
Seelim,1,0,37,0,37
Seemi,1,0,78,0,78
Seena,0,1,0,35,35
Seera,0,1,0,18,18
Seere,0,1,0,10,10
Seet,1,0,16,0,16
Seeti,1,0,50,0,50
Sefania,1,0,13,0,13
Sefanias,1,0,42,0,42
Sefanja,1,0,10,0,10
Sefer,1,0,10,0,10
Seidi,0,1,0,291,291
Seif,1,0,20,0,20
Seija,0,1,0,24759,24759
Seija-Leena,0,1,0,33,33
Seija-Liisa,0,1,0,133,133
Seija-Riitta,0,1,0,63,63
Seija-Sinikka,0,1,0,10,10
Seija-Sisko,0,1,0,31,31
Seikko,1,0,11,0,11
Seila,0,1,0,27,27
Seita,0,1,0,46,46
Selda,0,1,0,21,21
Selen,0,1,0,10,10
Selena,0,1,0,242,242
Selene,0,1,0,123,123
Selia,0,1,0,17,17
Seliina,0,1,0,204,204
Selim,1,0,270,0,270
Selin,0,1,0,19,19
Selina,0,1,0,1436,1436
Selinda,0,1,0,97,97
Selja,0,1,0,523,523
Sella,0,1,0,86,86
Selma,0,1,0,2057,2057
Selmi,0.5,0.5,12,12,24
Sem,1,0,38,0,38
Sema,0,1,0,11,11
Semen,1,0,14,0,14
Semi,1,0,103,0,103
Semih,1,0,13,0,13
Semir,1,0,15,0,15
Semmi,1,0,22,0,22
Semra,0,1,0,12,12
Sena,0,1,0,16,16
Senad,1,0,15,0,15
Seni,0,1,0,13,13
Senia,0,1,0,42,42
Senita,0,1,0,16,16
Senja,0,1,0,3248,3248
Senna,0,1,0,121,121
Senni,0,1,0,2081,2081
Senni-Sofia,0,1,0,13,13
Sennu,0,1,0,12,12
Senny,0,1,0,29,29
Senobia,0,1,0,14,14
Sepastian,1,0,15,0,15
Sepeteus,1,0,30,0,30
Seponpoika,1,0,105,0,105
Sepontytär,0,1,0,21,21
Seppo,1,0,35354,0,35354
Seppo-Ilmari,1,0,10,0,10
Sera,0,1,0,106,106
Serafia,0,1,0,656,656
Serafiia,0,1,0,86,86
Serafiina,0,1,0,972,972
Serafim,1,0,20,0,20
Serafima,0,1,0,35,35
Serafina,0,1,0,446,446
Seraphina,0,1,0,12,12
Serdar,1,0,16,0,16
Sere,1,0,10,0,10
Seren,0,1,0,12,12
Serena,0,1,0,173,173
Serenella,0,1,0,14,14
Serge,1,0,24,0,24
Sergeevna,0,1,0,15,15
Sergei,1,0,436,0,436
Sergej,1,0,16,0,16
Sergejevna,0,1,0,13,13
Sergey,1,0,179,0,179
Sergio,1,0,29,0,29
Sergiy,1,0,11,0,11
Serguei,1,0,64,0,64
Serhat,1,0,24,0,24
Seri,0,1,0,12,12
Serina,0,1,0,68,68
Serita,0,1,0,12,12
Serja,0,1,0,22,22
Serkan,1,0,23,0,23
Serko,1,0,10,0,10
Sesilia,0,1,0,171,171
Sesilja,0,1,0,12,12
Sessa,0,1,0,12,12
Set,1,0,19,0,19
Setareh,0,1,0,10,10
Seth,1,0,87,0,87
Setti,1,0,65,0,65
Sevda,0,1,0,13,13
Seve,1,0,10,0,10
Severi,1,0,4177,0,4177
Severiina,0,1,0,223,223
Severin,1,0,158,0,158
Severina,0,1,0,15,15
Severus,1,0,88,0,88
Sevgi,0,1,0,20,20
Seyed,1,0,51,0,51
Seyedeh,0,1,0,10,10
Seynab,0,1,0,21,21
Seyyed,1,0,10,0,10
Shabnam,0,1,0,15,15
Shahad,0,1,0,10,10
Shahid,1,0,16,0,16
Shahin,0.75,0.25,30,10,40
Shahla,0,1,0,24,24
Shahnaz,0,1,0,11,11
Shaker,1,0,12,0,12
Shakir,1,0,10,0,10
Shakira,0,1,0,15,15
Shamso,0,1,0,22,22
Shan,0,1,0,16,16
Shane,1,0,20,0,20
Shani,0,1,0,24,24
Shania,0,1,0,22,22
Shannon,0,1,0,31,31
Shanti,0,1,0,24,24
Shari,0,1,0,12,12
Sharif,0.701298701298701,0.298701298701299,54,23,77
Sharmarke,1,0,14,0,14
Sharmin,0,1,0,13,13
Sharon,0,1,0,110,110
Sharona,0,1,0,12,12
Shaun,1,0,18,0,18
Shawn,1,0,29,0,29
Shayan,1,0,12,0,12
Sheida,0,1,0,10,10
Sheikh,0.739130434782609,0.260869565217391,51,18,69
Sheila,0,1,0,57,57
Sherif,0.688888888888889,0.311111111111111,31,14,45
Shima,0,1,0,11,11
Shira,0,1,0,16,16
Shire,0.516129032258065,0.483870967741935,16,15,31
Shirel,0,1,0,10,10
Shiri,0,1,0,11,11
Shirin,0,1,0,46,46
Shirley,0,1,0,35,35
Shpresa,0,1,0,10,10
Shqipe,0,1,0,10,10
Shu,0,1,0,11,11
Shukri,0,1,0,47,47
Shukrije,0,1,0,12,12
Shwan,1,0,15,0,15
Si,0,1,0,10,10
Sibel,0,1,0,43,43
Sibylla,0,1,0,16,16
Sickan,0,1,0,40,40
Sid,1,0,15,0,15
Sidney,1,0,19,0,19
Sidonia,0,1,0,24,24
Siegfried,1,0,26,0,26
Siena,0,1,0,14,14
Sienna,0,1,0,183,183
Sierra,0,1,0,14,14
Sievä,0,1,0,61,61
Sievi,0,1,0,21,21
Sigbritt,0,1,0,52,52
Sig-Britt,0,1,0,16,16
Sigfrid,1,0,331,0,331
Sigge,1,0,22,0,22
Sigismund,1,0,17,0,17
Signar,1,0,12,0,12
Signe,0,1,0,964,964
Signhild,0,1,0,78,78
Signild,0,1,0,17,17
Sigrid,0,1,0,601,601
Sigrun,0,1,0,17,17
Sigurd,1,0,441,0,441
Sigvald,1,0,102,0,102
Sigvard,1,0,269,0,269
Sihaam,0,1,0,15,15
Siham,0,1,0,29,29
Sihveri,1,0,45,0,45
Siilas,1,0,31,0,31
Siim,1,0,11,0,11
Siime,0,1,0,11,11
Siimon,1,0,53,0,53
Siimoni,1,0,10,0,10
Siina,0,1,0,545,545
Siinto,1,0,13,0,13
Siiri,0,1,0,9126,9126
Siiri-Maria,0,1,0,25,25
Siiri-Sofia,0,1,0,62,62
Siivertti,1,0,12,0,12
Sikke,0,1,0,17,17
Sikstus,1,0,13,0,13
Sikuriina,0,1,0,64,64
Sila,0,1,0,10,10
Silas,1,0,39,0,39
Silja,0,1,0,6099,6099
Silja-Maaria,0,1,0,10,10
Silja-Maria,0,1,0,30,30
Silja-Riitta,0,1,0,14,14
Silja-Sofia,0,1,0,15,15
Silje,0,1,0,22,22
Silke,0,1,0,26,26
Silla,0,1,0,72,72
Silmu,0,1,0,58,58
Silpa,0,1,0,63,63
Silva,0,1,0,441,441
Silvana,0,1,0,25,25
Silve,0,1,0,29,29
Silver,1,0,27,0,27
Silvi,0,1,0,19,19
Silvia,0,1,0,769,769
Silvio,1,0,26,0,26
Silvo,1,0,153,0,153
Sima,0,1,0,25,25
Simeon,1,0,830,0,830
Simeoni,1,0,143,0,143
Simi,1,0,15,0,15
Simin,0,1,0,10,10
Simo,1,0,11050,0,11050
Simo-Heikki,1,0,10,0,10
Simo-Matti,1,0,11,0,11
Simon,1,0,1653,0,1653
Simona,0,1,0,74,74
Simone,0.0465116279069767,0.953488372093023,12,246,258
Simonpoika,1,0,76,0,76
Simontytär,0,1,0,19,19
Simopekka,1,0,38,0,38
Simo-Pekka,1,0,206,0,206
Simo-Petteri,1,0,16,0,16
Simo-Samuli,1,0,12,0,12
Simo-Santeri,1,0,11,0,11
Sina,0.0645161290322581,0.935483870967742,14,203,217
Sinaida,0,1,0,37,37
Sinan,1,0,38,0,38
Sindi,0,1,0,25,25
Sindy,0,1,0,19,19
Sine,0,1,0,11,11
Sinea,0,1,0,11,11
Sinella,0,1,0,43,43
Sinem,0,1,0,13,13
Sinerva,0,1,0,10,10
Sinervo,0,1,0,18,18
Singh,1,0,168,0,168
Sini,0,1,0,9085,9085
Sini-Johanna,0,1,0,13,13
Sinikka,0,1,0,45797,45797
Sinikukka,0,1,0,15,15
Sini-Maaret,0,1,0,12,12
Sini-Maaria,0,1,0,70,70
Sini-Maarit,0,1,0,39,39
Sini-Mari,0,1,0,11,11
Sinimaria,0,1,0,12,12
Sini-Maria,0,1,0,93,93
Sini-Marika,0,1,0,12,12
Sinimarja,0,1,0,18,18
Sini-Marja,0,1,0,39,39
Sini-Meri,0,1,0,14,14
Sini-Orvokki,0,1,0,18,18
Sini-Päivi,0,1,0,10,10
Sini-Päivikki,0,1,0,16,16
Sinipilvi,0,1,0,11,11
Sini-Pilvi,0,1,0,31,31
Sini-Sofia,0,1,0,31,31
Sini-Susanna,0,1,0,21,21
Sinitta,0,1,0,16,16
Sinituuli,0,1,0,21,21
Sini-Tuuli,0,1,0,42,42
Sinituulia,0,1,0,10,10
Sini-Tuulia,0,1,0,95,95
Sinivuokko,0,1,0,18,18
Sini-Vuokko,0,1,0,31,31
Sinja,0,1,0,93,93
Sinna,0,1,0,500,500
Sinuhe,1,0,33,0,33
Sipi,1,0,109,0,109
Sipo,1,0,11,0,11
Sippo,1,0,67,0,67
Sipri,1,0,32,0,32
Sipriina,0,1,0,63,63
Sira,0,1,0,102,102
Sirena,0,1,0,70,70
Sirene,0,1,0,10,10
Siri,0,1,0,646,646
Siria,0,1,0,10,10
Sirikli,0,1,0,12,12
Sirin,0,1,0,19,19
Sirina,0,1,0,12,12
Sirius,0.661764705882353,0.338235294117647,45,23,68
Sirja,0,1,0,537,537
Sirje,0,1,0,111,111
Sirke,0,1,0,271,271
Sirkka,0,1,0,21048,21048
Sirkka-Leena,0,1,0,81,81
Sirkkaliisa,0,1,0,36,36
Sirkka-Liisa,0,1,0,4471,4471
Sirkka-Maija,0,1,0,30,30
Sirkku,0,1,0,3673,3673
Sirkku-Leena,0,1,0,16,16
Sirkku-Liisa,0,1,0,50,50
Siro,0.164179104477612,0.835820895522388,11,56,67
Sirpa,0,1,0,23769,23769
Sirpa-Helena,0,1,0,10,10
Sirpa-Leena,0,1,0,41,41
Sirpa-Liisa,0,1,0,259,259
Sirpa-Riitta,0,1,0,25,25
Sirppa,0,1,0,33,33
Siru,0,1,0,1222,1222
Sirwan,1,0,20,0,20
Sisi,0,1,0,11,11
Sisilia,0,1,0,10,10
Sisko,0,1,0,23562,23562
Sisko-Helena,0,1,0,13,13
Sisko-Liisa,0,1,0,57,57
Sisko-Maria,0,1,0,23,23
Sisko-Riitta,0,1,0,12,12
Sissel,0,1,0,44,44
Sissi,0,1,0,258,258
Sissy,0,1,0,10,10
Sisu,1,0,1906,0,1906
Sita,0,1,0,11,11
Siv,0,1,0,1234,1234
Siv-Britt,0,1,0,26,26
Sivert,1,0,21,0,21
Sivi,0,1,0,148,148
Sivia,0,1,0,33,33
Siviä,0,1,0,1773,1773
Siw,0,1,0,47,47
Sixten,1,0,393,0,393
Sky,0,1,0,19,19
Skye,0,1,0,29,29
Smilla,0,1,0,34,34
Snöfrid,0,1,0,44,44
Sofi,0,1,0,809,809
Sofia,0,1,0,54789,54789
Sofía,0,1,0,13,13
Sofia-Maria,0,1,0,12,12
Sofiane,1,0,15,0,15
Sofianna,0,1,0,279,279
Sofie,0,1,0,1726,1726
Sofiella,0,1,0,11,11
Sofiia,0,1,0,73,73
Sofiina,0,1,0,49,49
Sofija,0,1,0,24,24
Sofina,0,1,0,10,10
Sofiya,0,1,0,11,11
Sofja,0,1,0,14,14
Sofya,0,1,0,10,10
Soheil,1,0,12,0,12
Soheila,0,1,0,12,12
Sohrab,1,0,11,0,11
Sohvi,0,1,0,1092,1092
Sohvia,0,1,0,26,26
Soila,0,1,0,504,504
Soile,0,1,0,4948,4948
Soili,0,1,0,3039,3039
Soilikki,0,1,0,800,800
Soini,0.93542757417103,0.0645724258289703,536,37,573
Sointu,0.0310262529832936,0.968973747016706,52,1624,1676
Soja,0,1,0,64,64
Sol,0,1,0,25,25
Solange,0,1,0,29,29
Solbritt,0,1,0,61,61
Sol-Britt,0,1,0,78,78
Sole,0,1,0,98,98
Soledad,0,1,0,16,16
Soleil,0,1,0,11,11
Soli,0,1,0,12,12
Solin,0,1,0,16,16
Solina,0,1,0,37,37
Solja,0,1,0,244,244
Solmu,1,0,33,0,33
Solomon,1,0,47,0,47
Solveig,0,1,0,1978,1978
Solweig,0,1,0,21,21
Soma,0,1,0,56,56
Somchai,1,0,10,0,10
Son,1,0,35,0,35
Sona,0,1,0,16,16
Soni,1,0,19,0,19
Sonia,0,1,0,329,329
Sonja,0,1,0,8840,8840
Sonja-Maria,0,1,0,22,22
Sonny,1,0,38,0,38
Sony,1,0,12,0,12
Sonya,0,1,0,98,98
Sophia,0,1,0,764,764
Sophie,0,1,0,826,826
Soraja,0,1,0,83,83
Soran,1,0,16,0,16
Soraya,0,1,0,70,70
Sorella,0,1,0,81,81
Sören,1,0,307,0,307
Sorja,0,1,0,79,79
Sorjo,1,0,17,0,17
Spencer,1,0,19,0,19
Staffan,1,0,323,0,323
Stanislav,1,0,90,0,90
Stanislava,0,1,0,11,11
Stanislaw,1,0,20,0,20
Stanley,1,0,57,0,57
Stavros,1,0,22,0,22
Stefan,1,0,3202,0,3202
Stefani,0,1,0,20,20
Stefania,0,1,0,60,60
Stefanie,0,1,0,99,99
Stefano,1,0,57,0,57
Stefanos,1,0,40,0,40
Stefansdotter,0,1,0,19,19
Stefansson,1,0,10,0,10
Stefanus,1,0,80,0,80
Steffan,1,0,11,0,11
Steffen,1,0,14,0,14
Stella,0,1,0,1992,1992
Stellan,1,0,10,0,10
Sten,1,0,577,0,577
Sten-Erik,1,0,24,0,24
Sten-Olof,1,0,23,0,23
Stepan,1,0,52,0,52
Stephan,1,0,126,0,126
Stephanie,0,1,0,250,250
Stephen,1,0,129,0,129
Steve,1,0,93,0,93
Steven,1,0,165,0,165
Stewart,1,0,13,0,13
Stian,1,0,12,0,12
Stig,1,0,2295,0,2295
Stig-Erik,1,0,101,0,101
Stig-Göran,1,0,74,0,74
Stig-Johan,1,0,22,0,22
Stig-Ole,1,0,14,0,14
Stig-Olof,1,0,72,0,72
Stigsdotter,0,1,0,11,11
Stiina,0,1,0,836,836
Stina,0,1,0,1477,1477
Stina-Maria,0,1,0,19,19
Storm,1,0,14,0,14
Stuart,1,0,48,0,48
Sture,1,0,365,0,365
Sturle,1,0,16,0,16
Styrbjörn,1,0,55,0,55
Su,0,1,0,24,24
Suad,0,1,0,26,26
Sue,0,1,0,58,58
Suha,0,1,0,10,10
Suhaib,1,0,10,0,10
Sulamit,0,1,0,35,35
Sulamith,0,1,0,10,10
Sulayman,1,0,10,0,10
Suleima,0,1,0,69,69
Suleiman,0.679012345679012,0.320987654320988,55,26,81
Sulevi,0.943506115317414,0.0564938846825859,1620,97,1717
Suleyman,1,0,17,0,17
Süleyman,1,0,19,0,19
Sulho,1,0,69,0,69
Sulina,0,1,0,10,10
Sulo,1,0,4686,0,4686
Sulotar,0,1,0,11,11
Sultan,0,1,0,16,16
Sumaya,0,1,0,71,71
Sumeja,0,1,0,10,10
Sumeya,0,1,0,19,19
Summer,0,1,0,14,14
Sumu,1,0,32,0,32
Sun,1,0,11,0,11
Suna,0,1,0,44,44
Sundus,0,1,0,38,38
Sune,1,0,429,0,429
Sunil,1,0,11,0,11
Sunita,0,1,0,14,14
Sunna,0,1,0,79,79
Sunneva,0,1,0,20,20
Sunniva,0,1,0,21,21
Sunny,1,0,16,0,16
Suoma,0,1,0,1075,1075
Suometar,0,1,0,128,128
Suraya,0,1,0,12,12
Susa,0,1,0,324,324
Susan,0,1,0,1739,1739
Susana,0,1,0,52,52
Susann,0,1,0,554,554
Susanna,0,1,0,56739,56739
Susannah,0,1,0,29,29
Susanne,0,1,0,5770,5770
Susette,0,1,0,23,23
Susi,0,1,0,14,14
Susie,0,1,0,17,17
Suska,0,1,0,10,10
Susu,0,1,0,10,10
Suune,1,0,12,0,12
Suvi,0,1,0,13862,13862
Suvianna,0,1,0,34,34
Suvi-Anna,0,1,0,25,25
Suvi-Elina,0,1,0,29,29
Suvi-Johanna,0,1,0,15,15
Suvikki,0,1,0,18,18
Suvi-Kukka,0,1,0,18,18
Suvi-Maaria,0,1,0,85,85
Suvi-Maarit,0,1,0,35,35
Suvi-Maria,0,1,0,128,128
Suvimarja,0,1,0,12,12
Suvi-Marja,0,1,0,58,58
Suvi-Päivi,0,1,0,61,61
Suvi-Päivikki,0,1,0,188,188
Suvi-Pauliina,0,1,0,13,13
Suvi-Pilvi,0,1,0,11,11
Suvi-Sisko,0,1,0,25,25
Suvituuli,0,1,0,201,201
Suvi-Tuuli,0,1,0,328,328
Suvituulia,0,1,0,36,36
Suvi-Tuulia,0,1,0,287,287
Suvi-Tuulikki,0,1,0,38,38
Suzan,0,1,0,79,79
Suzana,0,1,0,25,25
Suzanna,0,1,0,29,29
Suzanne,0,1,0,130,130
Suzette,0,1,0,11,11
Svanhild,0,1,0,39,39
Svante,1,0,464,0,464
Svantte,1,0,21,0,21
Svea,0,1,0,573,573
Sven,1,0,2520,0,2520
Sven-Åke,1,0,18,0,18
Sven-Eric,1,0,13,0,13
Sven-Erik,1,0,241,0,241
Svenja,0,1,0,10,10
Sven-Ole,1,0,18,0,18
Sven-Olof,1,0,129,0,129
Sverker,1,0,31,0,31
Sverre,1,0,37,0,37
Svetlana,0,1,0,939,939
Svitlana,0,1,0,13,13
Sydney,0,1,0,20,20
Syed,1,0,32,0,32
Sylva,0,1,0,129,129
Sylvain,1,0,15,0,15
Sylvester,1,0,514,0,514
Sylvesteri,1,0,58,0,58
Sylvi,0,1,0,4109,4109
Sylvia,0,1,0,5415,5415
Sylvie,0,1,0,23,23
Synneve,0,1,0,11,11
Synnevi,0,1,0,15,15
Synnove,0,1,0,16,16
Synnöve,0,1,0,826,826
Syrilla,0,1,0,25,25
Syväri,1,0,30,0,30
Taava,0,1,0,63,63
Taave,1,0,25,0,25
Taavetti,1,0,1821,0,1821
Taavi,1,0,1831,0,1831
Tabassum,0,1,0,11,11
Tabita,0,1,0,22,22
Tadeusz,1,0,20,0,20
Tage,1,0,568,0,568
Taha,1,0,62,0,62
Tahar,1,0,10,0,10
Taher,1,0,34,0,34
Tahir,1,0,22,0,22
Tahiti,0,1,0,29,29
Tähkä,0,1,0,25,25
Tähti,0,1,0,73,73
Tahvo,1,0,155,0,155
Tai,1,0,19,0,19
Taia,0,1,0,17,17
Taiga,0,1,0,93,93
Taija,0,1,0,1997,1997
Taija-Leena,0,1,0,10,10
Taija-Maria,0,1,0,10,10
Taiju,0,1,0,25,25
Taika,0,1,0,1314,1314
Taikatuuli,0,1,0,26,26
Taika-Tuuli,0,1,0,18,18
Taika-Tuulia,0,1,0,24,24
Taila,0,1,0,21,21
Taimi,0,1,0,4650,4650
Taimo,1,0,102,0,102
Taina,0,1,0,10085,10085
Taina-Liisa,0,1,0,11,11
Taini,0,1,0,27,27
Taira,0,1,0,47,47
Taisa,0,1,0,28,28
Taisia,0,1,0,51,51
Taisto,1,0,7358,0,7358
Taito,1,0,1253,0,1253
Talia,0,1,0,11,11
Talib,1,0,14,0,14
Talvi,0.22,0.78,11,39,50
Talvikki,0,1,0,4458,4458
Tam,0.493333333333333,0.506666666666667,37,38,75
Tamara,0,1,0,669,669
Tamás,1,0,17,0,17
Tamer,1,0,20,0,20
Tami,1,0,123,0,123
Tamim,1,0,10,0,10
Tan,1,0,52,0,52
Tancred,1,0,20,0,20
Tane,1,0,18,0,18
Tanel,1,0,12,0,12
Taneli,1,0,6065,0,6065
Tani,1,0,33,0,33
Tania,0,1,0,162,162
Tanita,0,1,0,59,59
Tanja,0,1,0,11598,11598
Tanjaana,0,1,0,12,12
Tanja-Maarit,0,1,0,13,13
Tanja-Maria,0,1,0,22,22
Tankred,1,0,11,0,11
Tanu,1,0,30,0,30
Tanya,0,1,0,184,184
Tao,1,0,20,0,20
Taoufik,1,0,12,0,12
Tapani,1,0,137688,0,137688
Tapaninpoika,1,0,39,0,39
Tapanintytär,0,1,0,13,13
Tapio,1,0,117650,0,117650
Tapionpoika,1,0,89,0,89
Tapiontytär,0,1,0,32,32
Tapsa,1,0,10,0,10
Tara,0,1,0,586,586
Taras,1,0,11,0,11
Tarek,1,0,53,0,53
Tari,0,1,0,26,26
Taria,0,1,0,15,15
Tarik,1,0,44,0,44
Tarina,0,1,0,71,71
Tariq,1,0,38,0,38
Tarita,0,1,0,88,88
Tarja,0,1,0,26598,26598
Tarjaana,0,1,0,20,20
Tarja-Anneli,0,1,0,11,11
Tarja-Helena,0,1,0,17,17
Tarja-Leena,0,1,0,173,173
Tarja-Liisa,0,1,0,154,154
Tarja-Maarit,0,1,0,10,10
Tarja-Maija,0,1,0,10,10
Tarja-Riitta,0,1,0,61,61
Tarja-Sisko,0,1,0,11,11
Tarja-Terttu,0,1,0,13,13
Tarja-Tuulikki,0,1,0,58,58
Tarkan,1,0,14,0,14
Tarkko,1,0,28,0,28
Tarleena,0,1,0,210,210
Tarmo,1,0,5149,0,5149
Tarmonpoika,1,0,20,0,20
Taro,1,0,55,0,55
Taru,0.0043045866112513,0.995695413388749,29,6708,6737
Taru-Leena,0,1,0,10,10
Taru-Maija,0,1,0,15,15
Taru-Maria,0,1,0,15,15
Taru-Tuuli,0,1,0,14,14
Taru-Tuulia,0,1,0,31,31
Tarvo,1,0,101,0,101
Tasnim,0,1,0,20,20
Tate,1,0,10,0,10
Tatiana,0,1,0,758,758
Tatja,0,1,0,98,98
Tatjaana,0,1,0,183,183
Tatjana,0,1,0,781,781
Tatu,1,0,4555,0,4555
Tatu-Matti,1,0,15,0,15
Tatunpoika,1,0,11,0,11
Tatu-Pekka,1,0,39,0,39
Tatyana,0,1,0,27,27
Tauno,1,0,8972,0,8972
Taunonpoika,1,0,13,0,13
Tauri,1,0,21,0,21
Tawan,1,0,17,0,17
Tawfik,0.521739130434783,0.478260869565217,12,11,23
Tayfun,1,0,11,0,11
Taylor,0.529411764705882,0.470588235294118,18,16,34
Tea,0,1,0,2609,2609
Tea-Maria,0,1,0,14,14
Ted,1,0,261,0,261
Teddy,1,0,49,0,49
Teea,0,1,0,449,449
Teela,0,1,0,20,20
Teemu,1,0,21748,0,21748
Teemunpoika,1,0,53,0,53
Teemuntytär,0,1,0,25,25
Teemu-Pekka,1,0,18,0,18
Teemu-Petteri,1,0,19,0,19
Tehilla,0,1,0,60,60
Teija,0,1,0,7365,7365
Teija-Leena,0,1,0,19,19
Teija-Liisa,0,1,0,35,35
Teija-Riitta,0,1,0,18,18
Teijo,1,0,2150,0,2150
Teijonpoika,1,0,19,0,19
Teiju,0,1,0,26,26
Teila,0,1,0,12,12
Tekla,0,1,0,260,260
Teljo,1,0,19,0,19
Tella,0,1,0,47,47
Telle,0,1,0,39,39
Tellervo,0,1,0,33591,33591
Tellu,0,1,0,15,15
Telma,0,1,0,238,238
Tempo,1,0,13,0,13
Tenhikki,0,1,0,10,10
Tenho,1,0,1884,0,1884
Teno,1,0,10,0,10
Teo,1,0,805,0,805
Teodor,1,0,735,0,735
Teodora,0,1,0,51,51
Teofiilus,1,0,13,0,13
Teofilus,1,0,41,0,41
Teoman,1,0,14,0,14
Teponpoika,1,0,16,0,16
Tepontytär,0,1,0,14,14
Teppana,1,0,12,0,12
Teppo,1,0,3316,0,3316
Terella,0,1,0,10,10
Terence,1,0,26,0,26
Teres,0,1,0,15,15
Teresa,0,1,0,2562,2562
Terésa,0,1,0,16,16
Terese,0,1,0,618,618
Terése,0,1,0,48,48
Teresia,0,1,0,968,968
Terésia,0,1,0,11,11
Teresita,0,1,0,12,12
Teressa,0,1,0,29,29
Tereza,0,1,0,19,19
Terhen,0,1,0,10,10
Terhi,0,1,0,8010,8010
Terhikki,0,1,0,1367,1367
Terhi-Liisa,0,1,0,13,13
Terhi-Marja,0,1,0,14,14
Terhi-Tuulia,0,1,0,17,17
Terhi-Tuulikki,0,1,0,12,12
Terho,1,0,2583,0,2583
Teri,0.419354838709677,0.580645161290323,13,18,31
Terja,0,1,0,93,93
Terje,1,0,31,0,31
Terjo,1,0,50,0,50
Terno,1,0,250,0,250
Tero,1,0,15126,0,15126
Tero-Matti,1,0,25,0,25
Teronpoika,1,0,93,0,93
Terontytär,0,1,0,30,30
Tero-Pekka,1,0,71,0,71
Tero-Petteri,1,0,13,0,13
Tero-Tapani,1,0,10,0,10
Tero-Tapio,1,0,13,0,13
Terri,0,1,0,12,12
Terry,1,0,30,0,30
Tertit,0,1,0,15,15
Tertta,0,1,0,14,14
Terttu,0,1,0,20566,20566
Terttu-Kaarina,0,1,0,15,15
Terttuli,0,1,0,19,19
Terttu-Liisa,0,1,0,81,81
Terttu-Maija,0,1,0,10,10
Tervo,1,0,10,0,10
Tesla,0,1,0,14,14
Tess,0,1,0,19,19
Tessa,0,1,0,919,919
Tessaliina,0,1,0,33,33
Tessi,0,1,0,15,15
Tetta,0,1,0,21,21
Tetti,0,1,0,30,30
Teudor,1,0,10,0,10
Teuta,0,1,0,18,18
Teutori,1,0,11,0,11
Teuvo,1,0,8422,0,8422
Teuvonpoika,1,0,12,0,12
Tex,1,0,11,0,11
Thai,1,0,31,0,31
Thalia,0,1,0,13,13
Thang,1,0,21,0,21
Thanh,0.497058823529412,0.502941176470588,169,171,340
Thao,0,1,0,76,76
The,1,0,40,0,40
Thea,0,1,0,317,317
Thelma,0,1,0,175,175
Theo,1,0,503,0,503
Théo,1,0,33,0,33
Theodor,1,0,429,0,429
Theodora,0,1,0,59,59
Theodore,1,0,72,0,72
Theodoros,1,0,18,0,18
Theres,0,1,0,25,25
Theresa,0,1,0,365,365
Therese,0,1,0,620,620
Therése,0,1,0,140,140
Thérése,0,1,0,10,10
Therèse,0,1,0,12,12
Thérèse,0,1,0,27,27
Theresé,0,1,0,12,12
Theresia,0,1,0,277,277
Thi,0,1,0,1114,1114
Thiago,1,0,12,0,12
Thien,0.675675675675676,0.324324324324324,50,24,74
Thierry,1,0,10,0,10
Thilda,0,1,0,20,20
Thilde,0,1,0,25,25
Tho,0,1,0,10,10
Thobias,1,0,12,0,12
Thomas,1,0,3585,0,3585
Thomasdotter,0,1,0,20,20
Thommy,1,0,24,0,24
Thong,1,0,10,0,10
Thor,1,0,246,0,246
Thora,0,1,0,14,14
Thorbjörn,1,0,32,0,32
Thor-Björn,1,0,11,0,11
Thord,1,0,14,0,14
Thordis,0,1,0,10,10
Thore,1,0,25,0,25
Thorleif,1,0,12,0,12
Thorolf,1,0,49,0,49
Thorsten,1,0,15,0,15
Thorvald,1,0,128,0,128
Thu,0,1,0,161,161
Thua,0,1,0,19,19
Thuong,0,1,0,14,14
Thure,1,0,87,0,87
Thuy,0,1,0,184,184
Thy,0,1,0,11,11
Thyra,0,1,0,66,66
Tia,0,1,0,1389,1389
Tiago,1,0,17,0,17
Tia-Mari,0,1,0,15,15
Tia-Maria,0,1,0,213,213
Tian,1,0,13,0,13
Tiana,0,1,0,56,56
Tianna,0,1,0,91,91
Tiara,0,1,0,21,21
Tibor,1,0,11,0,11
Tico,1,0,45,0,45
Tien,0.732394366197183,0.267605633802817,52,19,71
Tiera,1,0,21,0,21
Tiffany,0,1,0,60,60
Tiger,1,0,21,0,21
Tii,0,1,0,85,85
Tiia,0,1,0,8990,8990
Tiia-Emilia,0,1,0,10,10
Tiia-Leena,0,1,0,12,12
Tiia-Liisa,0,1,0,21,21
Tiia-Maaria,0,1,0,16,16
Tiia-Maarit,0,1,0,14,14
Tiiamari,0,1,0,33,33
Tiia-Mari,0,1,0,148,148
Tiiamaria,0,1,0,11,11
Tiia-Maria,0,1,0,379,379
Tiia-Mariia,0,1,0,14,14
Tiia-Marika,0,1,0,12,12
Tiia-Riikka,0,1,0,42,42
Tiia-Riina,0,1,0,40,40
Tiia-Riitta,0,1,0,13,13
Tiia-Sofia,0,1,0,12,12
Tiia-Tuulia,0,1,0,38,38
Tiida,0,1,0,17,17
Tiija,0,1,0,29,29
Tiila,0,1,0,65,65
Tiina,0,1,0,27711,27711
Tiina-Elina,0,1,0,13,13
Tiinakaisa,0,1,0,10,10
Tiina-Kaisa,0,1,0,74,74
Tiina-Leena,0,1,0,31,31
Tiinaliisa,0,1,0,17,17
Tiina-Liisa,0,1,0,173,173
Tiina-Maarit,0,1,0,18,18
Tiinamaija,0,1,0,12,12
Tiina-Maija,0,1,0,147,147
Tiinamari,0,1,0,29,29
Tiina-Mari,0,1,0,119,119
Tiina-Maria,0,1,0,126,126
Tiina-Marja,0,1,0,41,41
Tiina-Riikka,0,1,0,19,19
Tiina-Riitta,0,1,0,85,85
Tiina-Sisko,0,1,0,20,20
Tiina-Tuulia,0,1,0,15,15
Tiinu,0,1,0,20,20
Tiira,0,1,0,10,10
Tiiti,0,1,0,71,71
Tiitta,0,1,0,54,54
Tiitu,0,1,0,173,173
Tiitus,1,0,865,0,865
Tiiu,0,1,0,263,263
Tiivi,0,1,0,13,13
Tiko,1,0,23,0,23
Tikva,0,1,0,12,12
Tilda,0,1,0,1440,1440
Tilde,0,1,0,232,232
Tilhi,0,1,0,20,20
Tilja,0,1,0,15,15
Till,1,0,10,0,10
Tilla,0,1,0,36,36
Tilly,0,1,0,17,17
Tilma,0,1,0,118,118
Tilta,0,1,0,33,33
Tiltu,0,1,0,24,24
Tim,1,0,663,0,663
Timea,0,1,0,17,17
Timi,1,0,1382,0,1382
Timitri,1,0,43,0,43
Timjami,1,0,39,0,39
Timka,1,0,19,0,19
Timmy,1,0,85,0,85
Timna,0,1,0,16,16
Timo,1,0,50344,0,50344
Timofei,1,0,43,0,43
Timofey,1,0,10,0,10
Timo-Heikki,1,0,12,0,12
Timo-Jaakko,1,0,61,0,61
Timo-Juhani,1,0,24,0,24
Timo-Jukka,1,0,14,0,14
Timo-Jussi,1,0,13,0,13
Timo-Matti,1,0,21,0,21
Timon,1,0,13,0,13
Timonpoika,1,0,389,0,389
Timontytär,0,1,0,135,135
Timo-Pekka,1,0,269,0,269
Timo-Petteri,1,0,18,0,18
Timo-Tapani,1,0,14,0,14
Timo-Tapio,1,0,18,0,18
Timotei,1,0,36,0,36
Timoteus,1,0,156,0,156
Timothy,1,0,179,0,179
Timo-Veikko,1,0,11,0,11
Timur,1,0,79,0,79
Timy,1,0,10,0,10
Tin,1,0,15,0,15
Tina,0,1,0,1173,1173
Tina-Maria,0,1,0,15,15
Tindra,0,1,0,197,197
Ting,0,1,0,12,12
Tini,1,0,11,0,11
Tinja,0,1,0,986,986
Tinka,0,1,0,225,225
Tinna,0,1,0,51,51
Tino,1,0,2086,0,2086
Tintti,0,1,0,34,34
Tira,0,1,0,14,14
Tirlittan,0,1,0,14,14
Tita,0,1,0,95,95
Titania,0,1,0,15,15
Titi,0,1,0,33,33
Tito,1,0,89,0,89
Titta,0,1,0,1599,1599
Tittamari,0,1,0,11,11
Titta-Mari,0,1,0,13,13
Titta-Maria,0,1,0,26,26
Titta-Riina,0,1,0,14,14
Titti,0,1,0,58,58
Titus,1,0,165,0,165
Tiuku,0,1,0,107,107
To,0,1,0,15,15
Toan,1,0,17,0,17
Tobias,1,0,1788,0,1788
Toby,1,0,20,0,20
Todd,1,0,21,0,21
Toimi,1,0,653,0,653
Toini,0,1,0,5928,5928
Toive,0.194174757281553,0.805825242718447,20,83,103
Toivi,0.256410256410256,0.743589743589744,10,29,39
Toivikki,0,1,0,96,96
Toivo,1,0,17125,0,17125
Toivonpoika,1,0,10,0,10
Tom,1,0,4302,0,4302
Toma,0.830508474576271,0.169491525423729,49,10,59
Tomas,1,0,2717,0,2717
Tomás,1,0,29,0,29
Tomasdotter,0,1,0,16,16
Tomasz,1,0,36,0,36
Tomek,1,0,21,0,21
Tomer,1,0,14,0,14
Tom-Erik,1,0,30,0,30
Tomi,1,0,16103,0,16103
Tomi-Matti,1,0,11,0,11
Tominpoika,1,0,53,0,53
Tomintytär,0,1,0,19,19
Tomi-Pekka,1,0,69,0,69
Tomi-Petteri,1,0,43,0,43
Tom-Johan,1,0,11,0,11
Tommaso,1,0,23,0,23
Tommi,1,0,15071,0,15071
Tommie,1,0,23,0,23
Tomminpoika,1,0,76,0,76
Tommintytär,0,1,0,26,26
Tommi-Pekka,1,0,13,0,13
Tommi-Petteri,1,0,18,0,18
Tommo,1,0,19,0,19
Tommy,1,0,1887,0,1887
Tom-Peter,1,0,10,0,10
Tomppa,1,0,11,0,11
Tomsson,1,0,21,0,21
Tomy,1,0,48,0,48
Tone,0,1,0,16,16
Tong,1,0,11,0,11
Toni,0.999149081007488,0.000850918992511913,17613,15,17628
Toni-Kristian,1,0,14,0,14
Toni-Markus,1,0,17,0,17
Toni-Matti,1,0,15,0,15
Toni-Mikael,1,0,15,0,15
Toninpoika,1,0,50,0,50
Tonintytär,0,1,0,20,20
Toni-Pekka,1,0,52,0,52
Toni-Petri,1,0,15,0,15
Toni-Petteri,1,0,40,0,40
Toni-Tapio,1,0,12,0,12
Tonja,0,1,0,58,58
Tonny,1,0,15,0,15
Tony,0.993923024983119,0.00607697501688049,2944,18,2962
Tonya,0,1,0,11,11
Toomas,1,0,117,0,117
Topi,1,0,5043,0,5043
Topias,1,0,7503,0,7503
Topi-Matti,1,0,13,0,13
Topinpoika,1,0,10,0,10
Topi-Pekka,1,0,11,0,11
Topi-Petteri,1,0,10,0,10
Tor,1,0,1013,0,1013
Tora,0,1,0,80,80
Toralf,1,0,10,0,10
Tor-Alf,1,0,11,0,11
Torbjörn,1,0,502,0,502
Tor-Björn,1,0,56,0,56
Torborg,0,1,0,65,65
Tord,1,0,40,0,40
Tordis,0,1,0,21,21
Tore,1,0,302,0,302
Tor-Erik,1,0,118,0,118
Torgny,1,0,16,0,16
Torhild,0,1,0,27,27
Torkel,1,0,19,0,19
Torleif,1,0,33,0,33
Tor-Leif,1,0,30,0,30
Torolf,1,0,470,0,470
Torsten,1,0,1027,0,1027
Torstenson,1,0,10,0,10
Torstensson,1,0,18,0,18
Torsti,1,0,895,0,895
Torvald,1,0,481,0,481
Tosca,0,1,0,12,12
Toto,1,0,10,0,10
Totte,1,0,89,0,89
Totti,1,0,302,0,302
Touho,1,0,33,0,33
Touko,1,0,1511,0,1511
Toussaint,1,0,22,0,22
Toussainte,0,1,0,17,17
Tova,0,1,0,57,57
Tove,0,1,0,647,647
Towe,0,1,0,15,15
Tracy,0,1,0,14,14
Tram,0,1,0,14,14
Tran,0.394736842105263,0.605263157894737,15,23,38
Trang,0,1,0,67,67
Travis,1,0,23,0,23
Trevor,1,0,20,0,20
Tri,1,0,39,0,39
Tricia,0,1,0,11,11
Triin,0,1,0,17,17
Triinu,0,1,0,20,20
Trina,0,1,0,11,11
Trine,0,1,0,32,32
Trinh,0,1,0,22,22
Trinity,0,1,0,13,13
Tristan,1,0,222,0,222
Trong,1,0,33,0,33
Troy,1,0,51,0,51
Truc,0,1,0,30,30
Trude,0,1,0,18,18
Trung,1,0,42,0,42
Truong,1,0,21,0,21
Tryggve,1,0,63,0,63
Trygve,1,0,114,0,114
Tu,0.378378378378378,0.621621621621622,14,23,37
Tua,0,1,0,521,521
Tuan,1,0,82,0,82
Tuana,0,1,0,26,26
Tudor,1,0,10,0,10
Tuija,0,1,0,13232,13232
Tuija-Leena,0,1,0,41,41
Tuija-Liisa,0,1,0,52,52
Tuija-Maija,0,1,0,11,11
Tuija-Maria,0,1,0,11,11
Tuija-Riitta,0,1,0,26,26
Tuike,0,1,0,128,128
Tuikku,0,1,0,28,28
Tuila,0,1,0,22,22
Tuire,0,1,0,2024,2024
Tuisku,0.493506493506494,0.506493506493506,152,156,308
Tuittu,0,1,0,10,10
Tulan,0,1,0,10,10
Tuli,1,0,11,0,11
Tulikki,0,1,0,28,28
Tulikukka,0,1,0,24,24
Tung,1,0,32,0,32
Tuomaanpoika,1,0,96,0,96
Tuomaantytär,0,1,0,33,33
Tuomaksenpoika,1,0,15,0,15
Tuomas,1,0,28099,0,28099
Tuomi,0,1,0,52,52
Tuomikki,0,1,0,76,76
Tuomo,1,0,13106,0,13106
Tuomonpoika,1,0,76,0,76
Tuomontytär,0,1,0,31,31
Tuong,0.565217391304348,0.434782608695652,13,10,23
Tuovi,0.0354993983152828,0.964500601684717,59,1603,1662
Tupu,0,1,0,26,26
Tupuna,0,1,0,44,44
Ture,1,0,233,0,233
Turjo,1,0,14,0,14
Türkan,0,1,0,10,10
Turkka,1,0,474,0,474
Turo,1,0,694,0,694
Tutta,0,1,0,104,104
Tutteli,0,1,0,28,28
Tuttu,0,1,0,35,35
Tuua,0,1,0,56,56
Tuukanpoika,1,0,13,0,13
Tuukka,1,0,5419,0,5419
Tuula,0,1,0,36051,36051
Tuula-Anneli,0,1,0,49,49
Tuula-Kaarina,0,1,0,10,10
Tuula-Leena,0,1,0,10,10
Tuula-Maija,0,1,0,113,113
Tuula-Mari,0,1,0,10,10
Tuula-Maria,0,1,0,23,23
Tuula-Marja,0,1,0,87,87
Tuula-Marjatta,0,1,0,11,11
Tuula-Riitta,0,1,0,59,59
Tuulevi,0,1,0,419,419
Tuuli,0,1,0,6308,6308
Tuulia,0,1,0,19305,19305
Tuulianna,0,1,0,40,40
Tuuli-Anna,0,1,0,11,11
Tuuliina,0,1,0,84,84
Tuulikki,0,1,0,60793,60793
Tuuli-Maaria,0,1,0,38,38
Tuuli-Mari,0,1,0,13,13
Tuulimaria,0,1,0,12,12
Tuuli-Maria,0,1,0,75,75
Tuuni,0,1,0,48,48
Tuure,1,0,1435,0,1435
Tuutikki,0,1,0,44,44
Tuuva,0,1,0,16,16
Tuuve,0,1,0,30,30
Tuva,0,1,0,53,53
Tuyen,0,1,0,16,16
Tuyet,0,1,0,89,89
Ty,1,0,10,0,10
Tyko,1,0,167,0,167
Tyler,1,0,32,0,32
Tyra,0,1,0,116,116
Tyrsky,1,0,10,0,10
Tyson,1,0,16,0,16
Tyti,0,1,0,13,13
Tytteli,0,1,0,17,17
Tytti,0,1,0,3137,3137
Tytti-Maria,0,1,0,19,19
Tyttö,0,1,0,11,11
Tyyko,1,0,12,0,12
Tyyne,0,1,0,3485,3485
Tyyni,0,1,0,169,169
Tyyra,0,1,0,40,40
Ubah,0,1,0,24,24
Uddin,1,0,14,0,14
Udo,1,0,12,0,12
Ugochukwu,1,0,11,0,11
Ugur,1,0,16,0,16
Uki,1,0,42,0,42
Ukko,1,0,1851,0,1851
Ukkopekka,1,0,17,0,17
Ukko-Pekka,1,0,83,0,83
Ukri,1,0,42,0,42
Uku,1,0,10,0,10
Ulf,1,0,1354,0,1354
Ulf-Erik,1,0,28,0,28
Ulf-Peter,1,0,14,0,14
Ulfsdotter,0,1,0,31,31
Ulfsson,1,0,14,0,14
Uliana,0,1,0,13,13
Uljana,0,1,0,21,21
Uljas,1,0,1071,0,1071
Ulla,0,1,0,20780,20780
Ulla-Brita,0,1,0,48,48
Ulla-Britt,0,1,0,202,202
Ulla-Britta,0,1,0,35,35
Ulla-Christina,0,1,0,11,11
Ulla-Helena,0,1,0,18,18
Ulla-Kaarina,0,1,0,37,37
Ulla-Kaija,0,1,0,22,22
Ulla-Kaisa,0,1,0,41,41
Ulla-Kristiina,0,1,0,21,21
Ulla-Kristina,0,1,0,15,15
Ulla-Leena,0,1,0,44,44
Ulla-Liisa,0,1,0,35,35
Ulla-Maaria,0,1,0,14,14
Ulla-Maarit,0,1,0,37,37
Ullamaija,0,1,0,64,64
Ulla-Maija,0,1,0,2385,2385
Ulla-Maj,0,1,0,141,141
Ulla-Maja,0,1,0,11,11
Ullamari,0,1,0,35,35
Ulla-Mari,0,1,0,109,109
Ulla-Maria,0,1,0,140,140
Ulla-Marja,0,1,0,108,108
Ulla-May,0,1,0,15,15
Ulla-Pia,0,1,0,15,15
Ullariikka,0,1,0,18,18
Ulla-Riikka,0,1,0,59,59
Ulla-Riitta,0,1,0,237,237
Ulla-Sisko,0,1,0,15,15
Ullastiina,0,1,0,11,11
Ulla-Stina,0,1,0,62,62
Ulla-Terttu,0,1,0,10,10
Ull-Britt,0,1,0,28,28
Ülle,0,1,0,25,25
Ulli,0,1,0,14,14
Ullrika,0,1,0,12,12
Ulpu,0,1,0,477,477
Ulpukka,0,1,0,78,78
Ulrica,0,1,0,248,248
Ulrich,1,0,34,0,34
Ulriika,0,1,0,361,361
Ulriikka,0,1,0,492,492
Ulrik,1,0,83,0,83
Ulrika,0,1,0,2286,2286
Ulrike,0,1,0,24,24
Uma,0,1,0,58,58
Umar,1,0,17,0,17
Umberto,1,0,30,0,30
Ümit,1,0,13,0,13
Umut,1,0,22,0,22
Una,0,1,0,68,68
Unelma,0,1,0,2284,2284
Uni,0,1,0,42,42
Unikko,0,1,0,32,32
Unna,0,1,0,745,745
Unni,0,1,0,81,81
Unnukka,0,1,0,94,94
Uno,1,0,297,0,297
Untamo,1,0,2727,0,2727
Unto,1,0,4905,0,4905
Uolevi,1,0,13971,0,13971
Uoti,1,0,29,0,29
Upi,1,0,21,0,21
Urban,1,0,71,0,71
Urbanus,1,0,11,0,11
Urda,0,1,0,26,26
Urho,1,0,4730,0,4730
Uriel,1,0,20,0,20
Urmas,1,0,410,0,410
Urpo,1,0,2739,0,2739
Urpu,0,1,0,114,114
Ursula,0,1,0,1440,1440
Urve,0,1,0,12,12
Usama,1,0,14,0,14
Uskali,1,0,10,0,10
Usko,1,0,897,0,897
Usman,1,0,13,0,13
Usva,0,1,0,258,258
Utria,1,0,18,0,18
Utu,0.358974358974359,0.641025641025641,14,25,39
Uula,1,0,235,0,235
Uule,1,0,10,0,10
Uuna,0,1,0,19,19
Uuno,1,0,819,0,819
Uuras,1,0,89,0,89
Uwe,1,0,30,0,30
Uyen,0,1,0,16,16
Vaalimo,1,0,12,0,12
Vadelma,0,1,0,180,180
Vadim,1,0,127,0,127
Vahid,1,0,11,0,11
Vailet,0,1,0,16,16
Vaili,0,1,0,15,15
Väinämö,1,0,1188,0,1188
Väinämöinen,1,0,20,0,20
Väinö,1,0,14694,0,14694
Väinönpoika,1,0,13,0,13
Väiski,1,0,18,0,18
Vaito,1,0,107,0,107
Valbone,0,1,0,10,10
Valborg,0,1,0,388,388
Valde,1,0,517,0,517
Valdemar,1,0,7311,0,7311
Valdine,0,1,0,260,260
Valdo,1,0,15,0,15
Valencia,0,1,0,16,16
Valentiina,0,1,0,62,62
Valentin,1,0,1512,0,1512
Valentina,0,1,0,958,958
Valentine,0.25,0.75,11,33,44
Valentino,1,0,142,0,142
Valentinovna,0,1,0,12,12
Valeri,1,0,219,0,219
Valeria,0,1,0,308,308
Valerian,1,0,72,0,72
Valerie,0,1,0,78,78
Valerija,0,1,0,14,14
Valerio,1,0,10,0,10
Valerius,1,0,25,0,25
Valeriy,1,0,10,0,10
Valery,1,0,25,0,25
Valfrid,1,0,789,0,789
Valio,1,0,380,0,380
Valle,1,0,147,0,147
Vallu,1,0,14,0,14
Valma,0,1,0,1254,1254
Valmari,1,0,17,0,17
Valmu,0,1,0,13,13
Valo,0.957166392092257,0.042833607907743,581,26,607
Valon,1,0,18,0,18
Valonia,0,1,0,11,11
Valpas,1,0,78,0,78
Valpori,0,1,0,18,18
Valpu,0,1,0,49,49
Valpuri,0,1,0,1590,1590
Valtari,1,0,22,0,22
Valte,1,0,88,0,88
Valter,1,0,1759,0,1759
Valteri,1,0,23,0,23
Valto,1,0,1143,0,1143
Valtter,1,0,698,0,698
Valtteri,1,0,29296,0,29296
Valtti,1,0,128,0,128
Valvatti,0,1,0,20,20
Valvi,0,1,0,11,11
Valvikki,0,1,0,76,76
Van,0.853846153846154,0.146153846153846,333,57,390
Vanamo,0.018359853121175,0.981640146878825,15,802,817
Vanda,0,1,0,22,22
Vanesa,0,1,0,14,14
Vanessa,0,1,0,1891,1891
Vania,0,1,0,11,11
Vanilia,0,1,0,15,15
Vanilja,0,1,0,77,77
Vanilla,0,1,0,88,88
Vanja,0.219512195121951,0.780487804878049,18,64,82
Vanni,0,1,0,11,11
Vänni,1,0,16,0,16
Vappu,0,1,0,3565,3565
Varma,0.5,0.5,62,62,124
Varpu,0,1,0,1903,1903
Varpu-Leena,0,1,0,27,27
Varpu-Liisa,0,1,0,20,20
Varvara,0,1,0,57,57
Vasama,1,0,11,0,11
Vasili,1,0,95,0,95
Vasilij,1,0,23,0,23
Vasiliki,0,1,0,15,15
Vasilios,1,0,13,0,13
Vasilis,1,0,10,0,10
Vasilisa,0,1,0,18,18
Vasiljevna,0,1,0,25,25
Vasily,1,0,17,0,17
Vaula,0,1,0,361,361
Vaulikki,0,1,0,10,10
Vea,0,1,0,31,31
Vedat,1,0,12,0,12
Veea,0,1,0,52,52
Veela,0,1,0,43,43
Veele,1,0,11,0,11
Veeli,1,0,12,0,12
Veena,0,1,0,39,39
Veera,0,1,0,10856,10856
Veera-Kaisa,0,1,0,20,20
Veera-Liisa,0,1,0,10,10
Veera-Maria,0,1,0,61,61
Veera-Sofia,0,1,0,15,15
Veerti,1,0,57,0,57
Veeti,1,0,7511,0,7511
Veeti-Valtteri,1,0,29,0,29
Veetu,1,0,94,0,94
Vega,0,1,0,44,44
Veija,1,0,22,0,22
Veijo,1,0,7365,0,7365
Veijonpoika,1,0,18,0,18
Veikka,1,0,4105,0,4105
Veikko,1,0,36106,0,36106
Veikonpoika,1,0,31,0,31
Veina,0,1,0,14,14
Veini,1,0,255,0,255
Veino,1,0,22,0,22
Veka,1,0,44,0,44
Veli,1,0,21214,0,21214
Veli-Antero,1,0,12,0,12
Veli-Antti,1,0,54,0,54
Veli-Erkki,1,0,14,0,14
Veli-Hannu,1,0,16,0,16
Veli-Heikki,1,0,63,0,63
Veli-Jaakko,1,0,15,0,15
Veli-Juhani,1,0,60,0,60
Veli-Jukka,1,0,74,0,74
Veli-Jussi,1,0,87,0,87
Veli-Kalle,1,0,16,0,16
Veli-Markku,1,0,39,0,39
Veli-Markus,1,0,30,0,30
Veli-Martti,1,0,28,0,28
Veli-Matias,1,0,11,0,11
Velimatti,1,0,71,0,71
Veli-Matti,1,0,4094,0,4094
Velimies,1,0,20,0,20
Veli-Mies,1,0,22,0,22
Veli-Mikko,1,0,53,0,53
Velinpoika,1,0,12,0,12
Velipekka,1,0,57,0,57
Veli-Pekka,1,0,2788,0,2788
Veli-Pentti,1,0,21,0,21
Veli-Petri,1,0,32,0,32
Veli-Petteri,1,0,72,0,72
Veli-Sakari,1,0,10,0,10
Veli-Seppo,1,0,10,0,10
Veli-Tapani,1,0,23,0,23
Veli-Tapio,1,0,26,0,26
Veli-Tuomas,1,0,12,0,12
Veli-Valtteri,1,0,30,0,30
Veli-Veikko,1,0,28,0,28
Veli-Viljami,1,0,11,0,11
Veli-Ville,1,0,26,0,26
Vella,0,1,0,84,84
Vellamo,0.00968054211035818,0.990319457889642,10,1023,1033
Vellu,1,0,19,0,19
Velma,0,1,0,47,47
Velmeri,1,0,47,0,47
Velmu,1,0,21,0,21
Velu,1,0,79,0,79
Vendela,0,1,0,102,102
Vendi,0,1,0,11,11
Vendla,0,1,0,94,94
Venera,0,1,0,17,17
Venja,0,1,0,57,57
Venla,0,1,0,8465,8465
Venla-Maria,0,1,0,29,29
Venna,0,1,0,33,33
Venne,1,0,44,0,44
Venner,1,0,19,0,19
Venneri,1,0,82,0,82
Venni,0.889937106918239,0.110062893081761,566,70,636
Vennu,1,0,38,0,38
Venny,0,1,0,203,203
Vento,1,0,19,0,19
Venus,0,1,0,26,26
Vera,0,1,0,1928,1928
Vera-Maria,0,1,0,15,15
Verena,0,1,0,44,44
Verna,0,1,0,845,845
Verne,1,0,140,0,140
Verner,1,0,1693,0,1693
Verneri,1,0,5325,0,5325
Vernon,1,0,14,0,14
Verona,0,1,0,88,88
Veronica,0,1,0,1352,1352
Veronika,0,1,0,747,747
Veronique,0,1,0,10,10
Véronique,0,1,0,10,10
Vertti,1,0,1360,0,1360
Vesa,1,0,18746,0,18746
Vesa-Antti,1,0,11,0,11
Vesa-Heikki,1,0,50,0,50
Vesa-Jukka,1,0,29,0,29
Vesamatti,1,0,18,0,18
Vesa-Matti,1,0,807,0,807
Vesa-Mikko,1,0,11,0,11
Vesanpoika,1,0,129,0,129
Vesantytär,0,1,0,39,39
Vesa-Pekka,1,0,540,0,540
Vesa-Petri,1,0,23,0,23
Vesa-Petteri,1,0,34,0,34
Vesa-Tapio,1,0,14,0,14
Vesa-Valtteri,1,0,11,0,11
Vesa-Veikko,1,0,15,0,15
Vesa-Ville,1,0,21,0,21
Vesseli,1,0,12,0,12
Vesta,0,1,0,47,47
Vesteri,1,0,44,0,44
Vexi,1,0,12,0,12
Vi,0.368421052631579,0.631578947368421,14,24,38
Via,0,1,0,14,14
Viacheslav,1,0,24,0,24
Vianna,0,1,0,12,12
Viatcheslav,1,0,24,0,24
Vibeke,0,1,0,20,20
Vicente,1,0,27,0,27
Vicktor,1,0,14,0,14
Vicktoria,0,1,0,17,17
Vicky,0,1,0,21,21
Victor,1,0,1430,0,1430
Victoria,0,1,0,2664,2664
Vida,0,1,0,44,44
Vidar,1,0,242,0,242
Vide,1,0,23,0,23
Viena,0,1,0,627,627
Vienna,0,1,0,65,65
Vieno,0.0498154981549815,0.950184501845018,189,3605,3794
Viet,1,0,43,0,43
Viggo,1,0,180,0,180
Vihtor,1,0,22,0,22
Vihtori,1,0,5321,0,5321
Viia,0,1,0,159,159
Viima,0.536585365853659,0.463414634146341,22,19,41
Viimo,1,0,14,0,14
Viivi,0,1,0,6516,6516
Viivia,0,1,0,26,26
Viivi-Lotta,0,1,0,13,13
Viivi-Maria,0,1,0,38,38
Viivi-Sofia,0,1,0,10,10
Viki,1,0,54,0,54
Viking,1,0,900,0,900
Vikke,1,0,143,0,143
Vikki,1,0,13,0,13
Viktor,1,0,3457,0,3457
Viktori,1,0,30,0,30
Viktoria,0,1,0,1581,1581
Viktoriina,0,1,0,58,58
Viktorija,0,1,0,19,19
Viktorina,0,1,0,41,41
Viktoriya,0,1,0,30,30
Viktorovna,0,1,0,36,36
Vilbert,1,0,34,0,34
Vilda,0,1,0,41,41
Vilgot,1,0,35,0,35
Vilhard,1,0,36,0,36
Vilhelm,1,0,7590,0,7590
Vilhelmi,1,0,1137,0,1137
Vilhelmiina,0,1,0,8861,8861
Vilhelmina,0,1,0,1002,1002
Vilho,1,0,10847,0,10847
Vili,1,0,4756,0,4756
Viliam,1,0,39,0,39
Viliina,0,1,0,221,221
Vilina,0,1,0,152,152
Vili-Pekka,1,0,27,0,27
Vili-Petteri,1,0,76,0,76
Vilius,1,0,11,0,11
Vili-Valtteri,1,0,126,0,126
Vili-Veikka,1,0,19,0,19
Vili-Veikko,1,0,32,0,32
Vili-Verneri,1,0,20,0,20
Vilja,0,1,0,2032,2032
Viljaana,0,1,0,15,15
Viljam,1,0,2417,0,2417
Vilja-Maria,0,1,0,21,21
Viljami,1,0,15966,0,15966
Vilja-Tuulia,0,1,0,10,10
Viljo,1,0,7382,0,7382
Vilkas,1,0,27,0,27
Vilkko,1,0,10,0,10
Vilkku,1,0,11,0,11
Vilko,1,0,27,0,27
Villa,0,1,0,22,22
Ville,1,0,33097,0,33097
Ville-Aleksi,1,0,19,0,19
Ville-Antti,1,0,28,0,28
Ville-Eemeli,1,0,36,0,36
Villehad,1,0,23,0,23
Villehard,1,0,215,0,215
Villehart,1,0,31,0,31
Ville-Heikki,1,0,28,0,28
Ville-Hermanni,1,0,20,0,20
Ville-Joonas,1,0,29,0,29
Ville-Juhani,1,0,38,0,38
Ville-Jussi,1,0,17,0,17
Ville-Kalle,1,0,23,0,23
Villem,1,0,13,0,13
Villemarkus,1,0,14,0,14
Ville-Markus,1,0,130,0,130
Ville-Martti,1,0,10,0,10
Ville-Matias,1,0,57,0,57
Villematti,1,0,17,0,17
Ville-Matti,1,0,305,0,305
Ville-Mikael,1,0,11,0,11
Ville-Mikko,1,0,37,0,37
Villenpoika,1,0,133,0,133
Villentytär,0,1,0,51,51
Ville-Oskari,1,0,60,0,60
Villepekka,1,0,13,0,13
Ville-Pekka,1,0,538,0,538
Ville-Pertti,1,0,17,0,17
Ville-Petteri,1,0,366,0,366
Ville-Sakari,1,0,16,0,16
Ville-Samuli,1,0,29,0,29
Ville-Tapani,1,0,13,0,13
Ville-Tapio,1,0,14,0,14
Ville-Tuomas,1,0,13,0,13
Ville-Valtteri,1,0,247,0,247
Ville-Veikka,1,0,32,0,32
Villeveikko,1,0,17,0,17
Ville-Veikko,1,0,992,0,992
Ville-Veli,1,0,12,0,12
Ville-Verneri,1,0,14,0,14
Ville-Vesa,1,0,16,0,16
Ville-Waltteri,1,0,28,0,28
Villiam,1,0,449,0,449
Villiina,0,1,0,65,65
Villy,1,0,11,0,11
Vilma,0,1,0,7492,7492
Vilma-Lotta,0,1,0,43,43
Vilma-Maria,0,1,0,10,10
Vilmer,1,0,64,0,64
Vilmeri,1,0,37,0,37
Vilmiina,0,1,0,111,111
Vilna,0,1,0,20,20
Vilpas,1,0,130,0,130
Vilperi,1,0,66,0,66
Vilpert,1,0,15,0,15
Vilpertti,1,0,79,0,79
Vilpiina,0,1,0,10,10
Vilppu,1,0,423,0,423
Vincent,1,0,899,0,899
Vincenzo,1,0,29,0,29
Vineta,0,1,0,45,45
Vinh,1,0,57,0,57
Vinha,1,0,15,0,15
Vinja,0,1,0,12,12
Vinsent,1,0,11,0,11
Vinsentti,1,0,11,0,11
Vinski,1,0,136,0,136
Viola,0,1,0,5793,5793
Violet,0,1,0,93,93
Violeta,0,1,0,39,39
Violetta,0,1,0,105,105
Violette,0,1,0,17,17
Viona,0,1,0,48,48
Virginia,0,1,0,147,147
Viri,0,1,0,14,14
Virmo,1,0,22,0,22
Virna,0,1,0,10,10
Virpa,0,1,0,15,15
Virpi,0,1,0,9611,9611
Virpi-Leena,0,1,0,17,17
Virpi-Liisa,0,1,0,24,24
Virpi-Maria,0,1,0,10,10
Virva,0,1,0,1060,1060
Virva-Tuulia,0,1,0,13,13
Virve,0,1,0,2340,2340
Visa,1,0,1094,0,1094
Visa-Matti,1,0,11,0,11
Visa-Pekka,1,0,14,0,14
Visar,1,0,11,0,11
Vita,0,1,0,10,10
Vitali,1,0,97,0,97
Vitalis,1,0,14,0,14
Vitaliy,1,0,10,0,10
Vitaly,1,0,23,0,23
Vito,1,0,39,0,39
Vittoria,0,1,0,13,13
Vittorio,1,0,19,0,19
Viva,0,1,0,79,79
Vivan,0,1,0,232,232
Viveca,0,1,0,489,489
Viveka,0,1,0,628,628
Vivi,0,1,0,400,400
Vivia,0,1,0,118,118
Vivian,0,1,0,1302,1302
Viviana,0,1,0,73,73
Viviane,0,1,0,25,25
Viviann,0,1,0,47,47
Vivi-Ann,0,1,0,118,118
Vivianna,0,1,0,66,66
Vivianne,0,1,0,69,69
Vivi-Anne,0,1,0,15,15
Vivica,0,1,0,50,50
Vivien,0,1,0,55,55
Vivienne,0,1,0,34,34
Viviikka,0,1,0,15,15
Vivika,0,1,0,88,88
Vjatseslav,1,0,22,0,22
Vjollca,0,1,0,15,15
Vlada,0,1,0,11,11
Vladimir,1,0,512,0,512
Vladimirovna,0,1,0,64,64
Vladislav,1,0,104,0,104
Vladislava,0,1,0,10,10
Vlora,0,1,0,12,12
Voima,1,0,33,0,33
Voitto,1,0,3734,0,3734
Voldemar,1,0,54,0,54
Volkan,1,0,15,0,15
Volmar,1,0,125,0,125
Volmari,1,0,91,0,91
Volodymyr,1,0,10,0,10
Volter,1,0,112,0,112
Vsevolod,1,0,10,0,10
Vu,0.807017543859649,0.192982456140351,46,11,57
Vuokko,0,1,0,6720,6720
Vy,0,1,0,40,40
Vyacheslav,1,0,12,0,12
Wael,1,0,12,0,12
Wah,1,0,11,0,11
Wahab,1,0,14,0,14
Wai,0.571428571428571,0.428571428571429,28,21,49
Wäinämö,1,0,21,0,21
Wäinö,1,0,257,0,257
Wairimu,0,1,0,20,20
Walborg,0,1,0,18,18
Waldemar,1,0,1205,0,1205
Waldine,0,1,0,10,10
Waldo,1,0,11,0,11
Waleed,1,0,13,0,13
Walentin,1,0,36,0,36
Walfrid,1,0,95,0,95
Wali,1,0,15,0,15
Walid,1,0,56,0,56
Walle,1,0,30,0,30
Walma,0,1,0,14,14
Walpuri,0,1,0,13,13
Walter,1,0,1081,0,1081
Walther,1,0,50,0,50
Walton,1,0,15,0,15
Waltter,1,0,174,0,174
Waltteri,1,0,2338,0,2338
Wambui,0,1,0,27,27
Wanda,0,1,0,61,61
Wanessa,0,1,0,10,10
Wangari,0,1,0,11,11
Wangui,0,1,0,12,12
Wanja,0,1,0,18,18
Wanjiku,0,1,0,23,23
Wanjiru,0,1,0,26,26
Warda,0,1,0,26,26
Warren,1,0,21,0,21
Warsame,1,0,20,0,20
Wayne,1,0,30,0,30
Weera,0,1,0,57,57
Weeti,1,0,116,0,116
Wei,0.557377049180328,0.442622950819672,34,27,61
Weikka,1,0,28,0,28
Weikko,1,0,31,0,31
Weli,1,0,13,0,13
Wellamo,0,1,0,42,42
Wen,0.484848484848485,0.515151515151515,16,17,33
Wendela,0,1,0,19,19
Wendla,0,1,0,17,17
Wendy,0,1,0,44,44
Wenla,0,1,0,151,151
Wenzel,1,0,12,0,12
Wera,0,1,0,77,77
Werna,0,1,0,12,12
Werner,1,0,560,0,560
Werneri,1,0,349,0,349
Weronica,0,1,0,15,15
Weronika,0,1,0,19,19
Wertti,1,0,30,0,30
Wesley,1,0,27,0,27
Wibe,1,0,12,0,12
Wictor,1,0,39,0,39
Wictoria,0,1,0,19,19
Widar,1,0,10,0,10
Wiggo,1,0,21,0,21
Wihtori,1,0,82,0,82
Wiivi,0,1,0,42,42
Wiking,1,0,41,0,41
Wiktor,1,0,72,0,72
Wiktoria,0,1,0,30,30
Wilbert,1,0,36,0,36
Wilda,0,1,0,42,42
Wilfred,1,0,20,0,20
Wilhard,1,0,15,0,15
Wilhelm,1,0,4973,0,4973
Wilhelmi,1,0,120,0,120
Wilhelmiina,0,1,0,3067,3067
Wilhelmina,0,1,0,1381,1381
Wilhelmine,0,1,0,27,27
Wilho,1,0,109,0,109
Wili,1,0,96,0,96
Wiliam,1,0,33,0,33
Wiliina,0,1,0,12,12
Wilina,0,1,0,10,10
Wilja,0,1,0,20,20
Wiljam,1,0,437,0,437
Wiljami,1,0,804,0,804
Wiljo,1,0,23,0,23
Will,1,0,10,0,10
Wille,1,0,438,0,438
Willehard,1,0,89,0,89
Willem,1,0,109,0,109
Willhard,1,0,13,0,13
Willhelm,1,0,32,0,32
Willi,1,0,17,0,17
William,1,0,3973,0,3973
Willie,1,0,10,0,10
Williina,0,1,0,10,10
Willjam,1,0,12,0,12
Willow,0,1,0,14,14
Willy,1,0,99,0,99
Wilma,0,1,0,1933,1933
Wilma-Lotta,0,1,0,10,10
Wilmer,1,0,228,0,228
Wilmiina,0,1,0,16,16
Wilson,1,0,40,0,40
Wilton,1,0,17,0,17
Win,1,0,13,0,13
Wincent,1,0,26,0,26
Wing,0.6,0.4,15,10,25
Winnie,0,1,0,12,12
Winston,1,0,71,0,71
Wiola,0,1,0,44,44
Wisam,1,0,13,0,13
Wivan,0,1,0,10,10
Wiveca,0,1,0,14,14
Wiveka,0,1,0,14,14
Wivi,0,1,0,31,31
Wladimir,1,0,12,0,12
Wladyslaw,1,0,12,0,12
Woitto,1,0,10,0,10
Wojciech,1,0,18,0,18
Woldemar,1,0,56,0,56
Wolf,1,0,26,0,26
Wolfgang,1,0,95,0,95
Wolmar,1,0,28,0,28
Wolter,1,0,24,0,24
Wyatt,1,0,10,0,10
Xander,1,0,18,0,18
Xavier,1,0,66,0,66
Xenia,0,1,0,132,132
Xiang,0,1,0,13,13
Xiao,0,1,0,22,22
Xin,0,1,0,23,23
Xiu,0,1,0,14,14
Xuan,0.589041095890411,0.410958904109589,43,30,73
Xue,0,1,0,14,14
Y,0,1,0,17,17
Yacine,1,0,15,0,15
Yada,0,1,0,10,10
Yael,0,1,0,31,31
Yagmur,0,1,0,18,18
Yahia,1,0,12,0,12
Yahya,1,0,67,0,67
Yahye,1,0,56,0,56
Yakup,1,0,15,0,15
Yamina,0,1,0,20,20
Yan,0.323076923076923,0.676923076923077,21,44,65
Yana,0,1,0,37,37
Yang,0.4,0.6,14,21,35
Yann,1,0,29,0,29
Yannick,1,0,29,0,29
Yaqub,1,0,11,0,11
Yara,0,1,0,21,21
Yaroslav,1,0,16,0,16
Yaseen,1,0,11,0,11
Yasemin,0,1,0,87,87
Yaser,1,0,11,0,11
Yasin,0.909836065573771,0.0901639344262295,111,11,122
Yasir,1,0,30,0,30
Yasmin,0,1,0,441,441
Yasmina,0,1,0,69,69
Yasmine,0,1,0,190,190
Yasser,1,0,25,0,25
Yassin,0.847222222222222,0.152777777777778,61,11,72
Yassine,1,0,18,0,18
Yavuz,1,0,14,0,14
Yaw,1,0,21,0,21
Yaxye,1,0,11,0,11
Ye,0,1,0,10,10
Yee,0,1,0,25,25
Yelena,0,1,0,14,14
Yemina,0,1,0,11,11
Yen,0,1,0,57,57
Yi,0,1,0,19,19
Yilmaz,1,0,15,0,15
Yin,0,1,0,16,16
Ying,0,1,0,61,61
Ykä,1,0,15,0,15
Yki,1,0,29,0,29
Ylermi,1,0,665,0,665
Ylva,0,1,0,265,265
Yngve,1,0,589,0,589
Yoav,1,0,10,0,10
Yoel,1,0,11,0,11
Yohannes,1,0,13,0,13
Yolanda,0,1,0,99,99
Yonatan,1,0,15,0,15
Yong,1,0,10,0,10
Yonis,1,0,28,0,28
Yoonis,1,0,20,0,20
Yosef,1,0,18,0,18
Youcef,1,0,19,0,19
Younes,1,0,40,0,40
Younis,1,0,10,0,10
Yousef,1,0,41,0,41
Yousif,1,0,29,0,29
Youssef,1,0,74,0,74
Yousuf,1,0,17,0,17
Yrjänä,1,0,785,0,785
Yrjö,1,0,9455,0,9455
Yrjönpoika,1,0,30,0,30
Yrjö-Pekka,1,0,10,0,10
Yrsa,0,1,0,125,125
Yu,0.387755102040816,0.612244897959184,19,30,49
Yuan,0.454545454545455,0.545454545454545,10,12,22
Yuk,0,1,0,10,10
Yuki,0,1,0,13,13
Yukio,1,0,10,0,10
Yulia,0,1,0,107,107
Yuliya,0,1,0,24,24
Yun,0,1,0,17,17
Yunus,1,0,35,0,35
Yuri,1,0,13,0,13
Yury,1,0,51,0,51
Yusef,1,0,10,0,10
Yusra,0,1,0,29,29
Yussuf,1,0,19,0,19
Yusuf,0.734072022160665,0.265927977839335,265,96,361
Yuusuf,1,0,20,0,20
Yves,1,0,23,0,23
Yvette,0,1,0,29,29
Yvonn,0,1,0,10,10
Yvonne,0,1,0,1305,1305
Zacharias,1,0,511,0,511
Zachary,1,0,77,0,77
Zachris,1,0,21,0,21
Zackarias,1,0,14,0,14
Zafer,1,0,10,0,10
Zahir,1,0,12,0,12
Zahra,0,1,0,222,222
Zahraa,0,1,0,38,38
Zaid,1,0,12,0,12
Zaida,0,1,0,101,101
Zainab,0,1,0,102,102
Zakari,1,0,21,0,21
Zakaria,1,0,111,0,111
Zakarias,1,0,47,0,47
Zakarie,1,0,11,0,11
Zakariya,1,0,35,0,35
Zakariye,1,0,21,0,21
Zaki,1,0,18,0,18
Zakia,0,1,0,10,10
Zamzam,0,1,0,20,20
Zana,1,0,12,0,12
Zandra,0,1,0,20,20
Zanna,0,1,0,22,22
Zara,0,1,0,92,92
Zarah,0,1,0,15,15
Zaya,1,0,11,0,11
Zaynab,0,1,0,16,16
Zeb,1,0,14,0,14
Zebastian,1,0,12,0,12
Zehra,0,1,0,19,19
Zeinab,0,1,0,88,88
Zeineb,0,1,0,13,13
Zeki,1,0,10,0,10
Zelda,0,1,0,23,23
Zena,0,1,0,11,11
Zenita,0,1,0,27,27
Zeynep,0,1,0,42,42
Zhanna,0,1,0,35,35
Ziad,1,0,15,0,15
Zilan,0,1,0,12,12
Zina,0,1,0,23,23
Zinaida,0,1,0,48,48
Zion,1,0,17,0,17
Zita,0,1,0,13,13
Zlata,0,1,0,11,11
Zoe,0,1,0,82,82
Zoé,0,1,0,18,18
Zoë,0,1,0,13,13
Zoey,0,1,0,11,11
Zofia,0,1,0,29,29
Zohra,0,1,0,21,21
Zoja,0,1,0,43,43
Zoltan,1,0,15,0,15
Zoltán,1,0,26,0,26
Zoran,1,0,10,0,10
Zoya,0,1,0,17,17
Zsolt,1,0,10,0,10
Zsuzsanna,0,1,0,19,19
Zuhair,1,0,10,0,10
Zuzanna,0,1,0,11,11
